ApplicationID,TestDate,QuantitativeScore,LogicalScore,VerbalScore,TotalScore
A00001,2024-12-03,30,15,27,72
A00002,2024-03-22,14,13,38,65
A00003,2023-12-18,12,18,28,58
A00004,2024-11-13,24,34,35,93
A00005,2024-07-17,28,10,16,54
A00006,2024-09-18,22,22,23,67
A00007,2024-12-02,18,14,30,62
A00008,2024-06-30,16,11,38,65
A00009,2024-03-11,26,19,14,59
A00010,2024-11-16,12,28,32,72
A00011,2024-05-15,40,19,15,74
A00012,2024-02-19,21,34,23,78
A00013,2024-10-07,25,39,40,104
A00014,2023-12-11,17,29,12,58
A00015,2024-03-15,21,18,23,62
A00016,2024-08-22,19,26,25,70
A00017,2024-10-11,29,20,11,60
A00018,2024-06-05,35,39,36,110
A00019,2024-05-22,26,27,26,79
A00020,2024-03-16,36,22,40,98
A00021,2024-11-29,29,30,36,95
A00022,2024-01-14,18,38,39,95
A00023,2024-09-19,25,11,15,51
A00024,2024-08-04,32,14,22,68
A00025,2024-07-10,33,12,38,83
A00026,2024-04-27,25,31,31,87
A00027,2024-03-25,33,24,34,91
A00028,2024-09-13,13,11,20,44
A00029,2024-11-12,27,37,16,80
A00030,2024-12-06,31,25,14,70
A00031,2024-05-22,17,16,16,49
A00032,2024-01-06,36,31,36,103
A00033,2024-08-28,40,40,34,114
A00034,2024-08-23,17,39,37,93
A00035,2023-12-16,17,22,39,78
A00036,2024-07-25,21,33,16,70
A00037,2024-01-18,17,16,36,69
A00038,2024-04-01,17,18,20,55
A00039,2024-08-21,28,12,30,70
A00040,2024-01-15,33,31,39,103
A00041,2024-11-16,12,15,36,63
A00042,2024-10-12,11,28,24,63
A00043,2024-06-10,28,23,18,69
A00044,2024-01-17,15,24,35,74
A00045,2024-06-01,39,33,19,91
A00046,2024-09-02,16,32,32,80
A00047,2024-01-26,21,32,10,63
A00048,2024-07-09,39,40,26,105
A00049,2024-08-08,34,27,27,88
A00050,2024-10-24,30,35,11,76
A00051,2024-10-06,11,22,14,47
A00052,2024-09-22,18,19,11,48
A00053,2024-02-15,39,27,12,78
A00054,2024-04-04,14,17,26,57
A00055,2024-04-02,27,39,32,98
A00056,2024-01-19,40,23,21,84
A00057,2024-11-20,23,18,37,78
A00058,2024-04-19,38,21,28,87
A00059,2024-07-21,33,40,17,90
A00060,2024-02-22,29,32,16,77
A00061,2024-09-25,32,28,37,97
A00062,2024-05-16,23,17,38,78
A00063,2024-05-02,34,16,27,77
A00064,2024-03-27,10,19,35,64
A00065,2024-01-15,20,30,19,69
A00066,2024-05-10,18,20,16,54
A00067,2024-04-09,18,30,21,69
A00068,2024-05-24,17,36,36,89
A00069,2024-11-01,21,18,25,64
A00070,2024-01-03,40,17,20,77
A00071,2024-03-09,18,40,19,77
A00072,2024-05-21,37,20,25,82
A00073,2024-06-16,16,31,27,74
A00074,2024-04-09,38,23,17,78
A00075,2024-08-16,14,24,29,67
A00076,2024-09-06,18,24,25,67
A00077,2024-10-06,35,22,28,85
A00078,2024-07-30,38,37,35,110
A00079,2024-08-30,24,13,32,69
A00080,2024-05-21,40,18,22,80
A00081,2024-09-29,28,35,19,82
A00082,2024-09-22,15,28,35,78
A00083,2024-08-14,35,37,32,104
A00084,2024-02-22,30,39,11,80
A00085,2024-06-24,11,37,38,86
A00086,2024-03-30,15,22,40,77
A00087,2023-12-25,11,39,23,73
A00088,2024-08-11,21,17,38,76
A00089,2024-08-13,24,10,19,53
A00090,2024-06-08,23,36,14,73
A00091,2024-10-03,20,38,25,83
A00092,2024-08-11,35,28,24,87
A00093,2024-06-12,31,14,18,63
A00094,2024-10-28,17,34,21,72
A00095,2024-06-06,39,19,26,84
A00096,2024-09-29,23,34,19,76
A00097,2024-02-19,16,16,21,53
A00098,2024-01-12,39,15,38,92
A00099,2024-09-11,33,13,13,59
A00100,2024-03-15,31,38,29,98
A00101,2024-07-22,22,17,21,60
A00102,2024-07-17,13,32,12,57
A00103,2024-05-06,11,26,10,47
A00104,2024-05-10,39,19,27,85
A00105,2024-03-18,40,25,27,92
A00106,2024-10-23,10,22,33,65
A00107,2024-10-04,39,21,36,96
A00108,2024-05-26,13,16,16,45
A00109,2024-10-04,16,24,18,58
A00110,2024-02-06,16,33,30,79
A00111,2024-05-01,39,25,40,104
A00112,2024-08-11,40,33,18,91
A00113,2024-09-30,24,11,16,51
A00114,2024-06-18,40,28,17,85
A00115,2024-12-06,11,22,26,59
A00116,2024-10-18,31,19,16,66
A00117,2024-11-24,26,24,35,85
A00118,2024-10-09,38,12,32,82
A00119,2024-10-19,22,21,39,82
A00120,2024-08-31,15,29,32,76
A00121,2023-12-18,35,28,22,85
A00122,2024-08-25,31,20,16,67
A00123,2024-03-09,33,20,14,67
A00124,2024-08-17,15,40,35,90
A00125,2024-06-02,21,39,32,92
A00126,2024-04-18,16,21,26,63
A00127,2024-05-10,13,15,34,62
A00128,2024-08-21,21,16,34,71
A00129,2024-10-14,17,25,23,65
A00130,2024-07-27,26,16,21,63
A00131,2024-06-23,27,18,33,78
A00132,2024-08-12,17,21,23,61
A00133,2024-02-25,31,12,22,65
A00134,2024-08-08,11,34,22,67
A00135,2023-12-12,35,15,14,64
A00136,2024-07-01,14,23,33,70
A00137,2024-07-16,21,13,25,59
A00138,2024-12-09,35,32,29,96
A00139,2024-11-26,31,32,29,92
A00140,2024-03-18,12,32,32,76
A00141,2024-11-11,11,27,23,61
A00142,2024-05-04,31,26,27,84
A00143,2024-05-04,19,30,21,70
A00144,2024-04-05,23,32,24,79
A00145,2024-08-19,20,10,40,70
A00146,2024-02-28,29,11,11,51
A00147,2024-09-05,35,14,32,81
A00148,2024-10-07,20,23,16,59
A00149,2024-05-31,37,36,21,94
A00150,2024-02-13,20,31,29,80
A00151,2024-12-01,35,25,11,71
A00152,2024-03-31,22,13,40,75
A00153,2024-10-21,11,28,34,73
A00154,2024-08-12,24,26,28,78
A00155,2024-06-30,18,32,10,60
A00156,2024-07-13,21,11,36,68
A00157,2024-10-29,27,12,28,67
A00158,2024-08-26,17,20,11,48
A00159,2024-04-22,20,38,13,71
A00160,2024-03-31,35,33,12,80
A00161,2024-08-25,17,21,40,78
A00162,2024-10-12,14,35,10,59
A00163,2024-05-29,20,16,28,64
A00164,2024-01-02,33,39,16,88
A00165,2023-12-29,23,23,20,66
A00166,2024-01-03,24,29,16,69
A00167,2024-09-18,17,24,20,61
A00168,2024-01-02,13,16,19,48
A00169,2024-01-15,35,25,10,70
A00170,2024-04-30,19,10,31,60
A00171,2024-04-11,27,13,15,55
A00172,2024-10-09,21,18,21,60
A00173,2024-07-07,26,26,22,74
A00174,2024-10-18,16,35,20,71
A00175,2024-10-27,16,20,21,57
A00176,2024-08-23,14,19,32,65
A00177,2024-11-27,27,20,35,82
A00178,2024-09-10,23,26,23,72
A00179,2024-10-28,23,38,33,94
A00180,2024-02-01,14,38,31,83
A00181,2024-11-24,14,39,14,67
A00182,2024-04-15,31,35,39,105
A00183,2024-05-14,29,36,40,105
A00184,2024-04-27,28,31,10,69
A00185,2024-10-01,20,28,33,81
A00186,2024-07-22,11,19,28,58
A00187,2024-09-07,39,18,35,92
A00188,2024-08-25,27,35,24,86
A00189,2024-07-29,31,26,19,76
A00190,2024-07-06,16,26,24,66
A00191,2024-05-27,12,37,39,88
A00192,2024-06-11,35,38,30,103
A00193,2024-06-03,18,38,38,94
A00194,2024-01-18,11,26,11,48
A00195,2024-05-08,15,29,10,54
A00196,2023-12-13,34,35,23,92
A00197,2024-06-08,25,24,35,84
A00198,2024-05-10,12,27,17,56
A00199,2024-06-06,19,20,40,79
A00200,2024-04-02,18,20,31,69
A00201,2024-01-31,37,13,37,87
A00202,2024-03-09,38,32,40,110
A00203,2024-01-14,26,27,36,89
A00204,2024-06-06,26,32,32,90
A00205,2024-04-14,17,19,25,61
A00206,2024-09-15,24,39,21,84
A00207,2024-09-09,25,37,17,79
A00208,2024-04-01,40,26,21,87
A00209,2024-06-13,35,22,35,92
A00210,2024-01-19,13,28,36,77
A00211,2024-05-11,17,28,27,72
A00212,2024-08-07,31,38,17,86
A00213,2024-02-16,18,12,31,61
A00214,2024-02-27,38,14,23,75
A00215,2024-04-01,21,32,39,92
A00216,2024-02-09,32,37,18,87
A00217,2024-09-14,25,21,31,77
A00218,2024-07-03,21,33,21,75
A00219,2024-08-08,27,19,18,64
A00220,2024-04-19,23,18,34,75
A00221,2023-12-21,27,29,14,70
A00222,2024-01-12,36,24,31,91
A00223,2024-04-13,38,31,28,97
A00224,2024-08-10,20,34,27,81
A00225,2024-11-14,36,21,33,90
A00226,2024-02-27,27,19,39,85
A00227,2024-01-06,40,17,18,75
A00228,2024-08-20,24,20,22,66
A00229,2024-11-29,24,13,38,75
A00230,2024-09-15,25,10,15,50
A00231,2024-10-27,37,26,35,98
A00232,2024-07-07,32,36,14,82
A00233,2024-12-06,24,23,17,64
A00234,2024-07-06,23,18,35,76
A00235,2024-08-07,21,14,11,46
A00236,2024-11-23,19,10,33,62
A00237,2024-10-26,15,34,32,81
A00238,2024-09-21,30,28,20,78
A00239,2024-06-13,30,24,12,66
A00240,2023-12-20,10,39,10,59
A00241,2024-10-06,10,28,28,66
A00242,2024-10-09,22,39,17,78
A00243,2023-12-18,35,20,18,73
A00244,2024-06-14,26,39,33,98
A00245,2024-02-03,25,17,28,70
A00246,2024-04-16,11,16,10,37
A00247,2024-12-07,22,18,31,71
A00248,2024-09-10,24,20,12,56
A00249,2024-04-06,11,10,36,57
A00250,2024-06-27,27,11,34,72
A00251,2024-08-21,39,27,15,81
A00252,2024-05-10,18,33,16,67
A00253,2024-05-08,36,19,28,83
A00254,2024-04-28,28,36,29,93
A00255,2024-03-05,23,40,11,74
A00256,2024-11-16,29,37,34,100
A00257,2024-12-08,24,25,40,89
A00258,2024-08-07,17,22,22,61
A00259,2023-12-14,12,17,16,45
A00260,2024-07-26,32,29,33,94
A00261,2024-06-21,37,31,23,91
A00262,2024-10-11,33,37,21,91
A00263,2023-12-27,19,23,34,76
A00264,2024-10-16,18,34,34,86
A00265,2024-09-23,17,21,33,71
A00266,2024-06-18,35,16,29,80
A00267,2024-06-24,29,37,31,97
A00268,2024-11-08,27,29,24,80
A00269,2024-10-27,22,34,20,76
A00270,2024-11-30,14,13,22,49
A00271,2024-10-06,14,12,16,42
A00272,2024-07-02,24,22,12,58
A00273,2024-11-02,27,30,40,97
A00274,2024-11-23,27,10,16,53
A00275,2024-09-09,11,19,35,65
A00276,2024-04-20,36,17,29,82
A00277,2024-10-22,39,22,18,79
A00278,2024-08-23,18,20,17,55
A00279,2024-05-11,16,24,24,64
A00280,2024-12-05,18,23,20,61
A00281,2024-02-21,39,29,11,79
A00282,2024-10-29,19,23,29,71
A00283,2024-08-31,36,23,11,70
A00284,2024-07-06,19,38,24,81
A00285,2024-10-16,40,28,40,108
A00286,2024-07-16,36,38,24,98
A00287,2024-06-01,30,34,37,101
A00288,2024-10-17,33,22,10,65
A00289,2024-12-01,10,32,15,57
A00290,2024-09-11,25,38,11,74
A00291,2024-04-05,32,28,27,87
A00292,2024-01-04,16,24,11,51
A00293,2024-02-21,25,31,38,94
A00294,2024-10-13,27,10,35,72
A00295,2024-12-05,37,22,13,72
A00296,2024-02-14,31,11,36,78
A00297,2024-08-21,40,39,25,104
A00298,2024-08-10,38,10,39,87
A00299,2023-12-27,36,34,21,91
A00300,2024-07-01,37,40,34,111
A00301,2023-12-29,10,35,30,75
A00302,2024-04-11,26,32,27,85
A00303,2024-07-03,10,18,29,57
A00304,2024-01-13,13,23,38,74
A00305,2024-06-04,28,18,23,69
A00306,2024-11-29,27,11,14,52
A00307,2024-05-20,19,28,20,67
A00308,2024-04-21,29,26,13,68
A00309,2024-11-28,32,26,36,94
A00310,2024-10-18,39,26,27,92
A00311,2024-01-24,24,39,15,78
A00312,2024-08-03,40,22,31,93
A00313,2024-02-29,10,21,11,42
A00314,2024-03-30,21,31,29,81
A00315,2024-09-21,33,10,34,77
A00316,2024-11-28,32,38,15,85
A00317,2024-05-30,14,30,27,71
A00318,2024-05-29,10,26,22,58
A00319,2024-03-16,28,31,32,91
A00320,2024-10-15,31,17,21,69
A00321,2024-11-02,31,24,21,76
A00322,2024-04-19,40,11,38,89
A00323,2024-09-19,15,18,33,66
A00324,2024-03-19,24,37,11,72
A00325,2024-09-05,35,16,27,78
A00326,2024-07-16,34,21,33,88
A00327,2024-07-18,35,28,10,73
A00328,2024-10-22,11,12,29,52
A00329,2024-05-27,19,31,31,81
A00330,2024-11-20,22,28,35,85
A00331,2024-11-15,15,19,38,72
A00332,2024-10-01,10,10,30,50
A00333,2024-09-19,18,38,30,86
A00334,2023-12-18,21,27,37,85
A00335,2024-12-06,37,16,15,68
A00336,2023-12-11,23,16,35,74
A00337,2023-12-17,19,31,19,69
A00338,2024-03-11,35,16,32,83
A00339,2024-02-19,21,11,13,45
A00340,2024-06-14,28,39,29,96
A00341,2024-07-21,34,17,36,87
A00342,2024-08-19,36,23,22,81
A00343,2024-11-30,20,29,11,60
A00344,2024-06-06,11,14,32,57
A00345,2024-07-03,10,24,13,47
A00346,2024-08-28,23,24,16,63
A00347,2024-10-26,22,39,33,94
A00348,2024-06-01,13,40,40,93
A00349,2024-06-23,31,31,14,76
A00350,2024-10-21,16,13,37,66
A00351,2024-07-22,38,38,35,111
A00352,2024-07-04,25,15,33,73
A00353,2024-10-15,15,23,21,59
A00354,2024-11-30,18,12,23,53
A00355,2023-12-28,13,11,40,64
A00356,2024-08-21,19,38,32,89
A00357,2024-08-05,35,14,16,65
A00358,2024-01-09,32,23,15,70
A00359,2024-09-27,31,16,18,65
A00360,2023-12-14,15,23,18,56
A00361,2024-05-24,23,35,18,76
A00362,2024-03-02,12,32,36,80
A00363,2024-07-01,33,31,33,97
A00364,2023-12-29,28,37,38,103
A00365,2024-01-23,19,34,24,77
A00366,2024-02-26,40,36,36,112
A00367,2024-09-21,28,29,19,76
A00368,2024-11-23,18,17,29,64
A00369,2024-04-19,36,20,33,89
A00370,2024-12-08,19,11,34,64
A00371,2024-11-18,39,26,13,78
A00372,2024-05-02,29,11,36,76
A00373,2024-07-05,34,25,35,94
A00374,2024-01-10,22,29,17,68
A00375,2024-11-11,14,34,34,82
A00376,2023-12-24,26,10,12,48
A00377,2024-11-18,24,12,30,66
A00378,2024-03-14,30,19,10,59
A00379,2024-04-19,22,17,32,71
A00380,2024-09-12,20,18,20,58
A00381,2024-05-31,39,21,26,86
A00382,2024-09-19,14,39,17,70
A00383,2024-06-24,14,37,11,62
A00384,2023-12-17,20,22,24,66
A00385,2024-02-04,25,14,27,66
A00386,2024-01-12,38,32,38,108
A00387,2024-06-09,18,24,26,68
A00388,2024-08-12,28,32,30,90
A00389,2024-04-15,30,19,36,85
A00390,2024-04-12,11,35,34,80
A00391,2024-07-18,10,30,10,50
A00392,2024-02-10,19,19,30,68
A00393,2024-02-05,31,16,28,75
A00394,2024-08-18,16,24,29,69
A00395,2024-12-01,28,25,24,77
A00396,2024-08-24,36,37,21,94
A00397,2024-09-20,29,38,34,101
A00398,2024-07-19,21,20,28,69
A00399,2024-10-29,34,38,22,94
A00400,2024-02-01,38,36,34,108
A00401,2024-01-26,37,39,36,112
A00402,2024-08-26,25,21,34,80
A00403,2024-10-31,10,10,21,41
A00404,2024-03-05,29,37,33,99
A00405,2024-02-05,32,28,22,82
A00406,2024-01-29,12,16,27,55
A00407,2024-08-09,18,37,25,80
A00408,2024-04-21,25,39,21,85
A00409,2024-02-28,17,14,27,58
A00410,2024-09-26,28,27,37,92
A00411,2024-06-01,13,15,16,44
A00412,2024-02-20,12,16,10,38
A00413,2024-10-28,23,27,14,64
A00414,2023-12-13,29,18,11,58
A00415,2024-06-10,22,29,21,72
A00416,2024-08-06,21,22,19,62
A00417,2024-03-30,15,14,17,46
A00418,2024-05-04,40,29,15,84
A00419,2024-08-12,40,14,13,67
A00420,2024-09-16,35,33,14,82
A00421,2024-02-04,12,14,10,36
A00422,2024-07-31,35,30,20,85
A00423,2024-02-01,40,10,24,74
A00424,2024-04-13,10,25,13,48
A00425,2024-02-06,27,36,11,74
A00426,2024-12-07,38,23,26,87
A00427,2023-12-25,33,24,11,68
A00428,2024-01-23,22,20,31,73
A00429,2023-12-17,40,26,12,78
A00430,2024-08-10,17,11,24,52
A00431,2024-04-10,32,32,12,76
A00432,2024-04-03,31,38,39,108
A00433,2024-06-02,17,17,10,44
A00434,2024-03-01,21,13,18,52
A00435,2024-09-05,14,35,17,66
A00436,2024-11-11,27,14,39,80
A00437,2024-03-06,40,16,22,78
A00438,2024-09-04,38,22,35,95
A00439,2023-12-24,14,35,10,59
A00440,2024-09-13,33,21,22,76
A00441,2023-12-24,30,31,27,88
A00442,2024-01-31,38,15,11,64
A00443,2024-11-14,20,38,24,82
A00444,2024-04-09,38,17,17,72
A00445,2024-08-01,15,21,21,57
A00446,2024-07-03,26,20,18,64
A00447,2024-07-08,35,37,22,94
A00448,2024-11-02,23,40,13,76
A00449,2024-05-02,28,10,34,72
A00450,2024-06-01,18,10,17,45
A00451,2024-07-02,33,23,20,76
A00452,2024-10-05,30,13,36,79
A00453,2024-10-24,19,14,10,43
A00454,2024-12-07,20,12,25,57
A00455,2024-09-24,16,20,32,68
A00456,2024-06-28,16,35,18,69
A00457,2024-09-29,25,35,33,93
A00458,2024-04-25,14,32,11,57
A00459,2024-02-05,10,13,25,48
A00460,2024-11-24,26,21,23,70
A00461,2024-01-01,38,17,34,89
A00462,2024-03-24,39,23,23,85
A00463,2024-08-14,20,18,13,51
A00464,2024-11-14,10,33,40,83
A00465,2024-11-28,12,20,13,45
A00466,2024-02-08,11,38,40,89
A00467,2024-04-06,37,23,35,95
A00468,2024-10-15,21,17,18,56
A00469,2024-07-24,14,22,16,52
A00470,2024-07-31,10,22,14,46
A00471,2024-01-21,37,38,19,94
A00472,2024-03-28,21,26,28,75
A00473,2024-06-25,18,37,15,70
A00474,2024-08-05,16,26,13,55
A00475,2024-08-24,36,12,29,77
A00476,2024-05-22,16,29,25,70
A00477,2024-05-05,15,12,30,57
A00478,2024-06-11,23,40,24,87
A00479,2024-04-19,17,24,21,62
A00480,2024-09-19,35,26,21,82
A00481,2024-08-24,33,32,25,90
A00482,2024-03-03,37,16,21,74
A00483,2024-01-26,36,31,34,101
A00484,2024-09-17,39,20,20,79
A00485,2024-04-23,35,14,10,59
A00486,2024-03-26,18,23,30,71
A00487,2024-03-05,36,18,22,76
A00488,2024-05-31,19,14,28,61
A00489,2024-08-13,16,29,40,85
A00490,2024-03-27,23,36,14,73
A00491,2023-12-29,36,40,17,93
A00492,2024-02-06,12,29,35,76
A00493,2023-12-21,10,13,31,54
A00494,2024-06-08,18,32,23,73
A00495,2024-10-01,12,13,19,44
A00496,2024-03-11,21,19,33,73
A00497,2024-10-02,18,20,40,78
A00498,2024-10-13,23,39,38,100
A00499,2023-12-11,12,26,31,69
A00500,2023-12-15,11,30,11,52
A00501,2024-09-12,25,19,33,77
A00502,2024-04-17,38,28,38,104
A00503,2024-09-21,11,37,38,86
A00504,2024-03-19,36,16,16,68
A00505,2024-11-26,12,29,29,70
A00506,2024-03-25,28,10,26,64
A00507,2024-10-11,17,38,31,86
A00508,2024-02-28,40,17,17,74
A00509,2024-10-05,22,26,29,77
A00510,2024-09-07,19,29,40,88
A00511,2024-07-31,24,24,34,82
A00512,2024-05-10,10,17,26,53
A00513,2024-08-02,26,26,12,64
A00514,2024-07-05,40,11,38,89
A00515,2024-03-23,19,26,39,84
A00516,2024-07-13,30,19,27,76
A00517,2024-03-19,14,17,11,42
A00518,2024-05-03,23,27,39,89
A00519,2024-11-13,36,22,10,68
A00520,2024-08-01,39,38,33,110
A00521,2023-12-27,13,26,39,78
A00522,2024-08-21,26,14,39,79
A00523,2024-03-29,26,23,12,61
A00524,2024-05-09,23,30,38,91
A00525,2024-11-19,15,20,15,50
A00526,2024-03-25,17,38,23,78
A00527,2024-04-09,13,39,31,83
A00528,2024-11-11,12,27,26,65
A00529,2023-12-27,35,35,18,88
A00530,2024-08-23,34,26,21,81
A00531,2023-12-27,12,26,18,56
A00532,2024-03-07,25,12,13,50
A00533,2024-08-16,22,39,12,73
A00534,2024-07-16,28,12,31,71
A00535,2024-02-09,11,14,11,36
A00536,2024-03-23,28,32,12,72
A00537,2023-12-20,19,40,11,70
A00538,2024-10-04,25,33,23,81
A00539,2024-08-14,11,27,23,61
A00540,2024-03-06,13,30,15,58
A00541,2024-08-02,18,11,12,41
A00542,2024-05-04,35,39,13,87
A00543,2024-11-04,36,17,29,82
A00544,2024-08-08,39,15,38,92
A00545,2024-06-10,18,25,16,59
A00546,2024-05-03,40,23,32,95
A00547,2024-06-24,24,15,11,50
A00548,2024-10-24,28,35,31,94
A00549,2024-08-18,33,10,12,55
A00550,2024-11-02,15,23,12,50
A00551,2024-02-09,23,19,22,64
A00552,2024-09-21,19,39,30,88
A00553,2024-03-25,23,39,15,77
A00554,2024-01-22,25,36,39,100
A00555,2024-08-15,37,10,18,65
A00556,2024-06-16,39,11,21,71
A00557,2024-02-16,19,11,34,64
A00558,2024-10-02,14,32,26,72
A00559,2024-10-19,32,10,10,52
A00560,2024-01-27,37,35,34,106
A00561,2024-09-04,10,12,37,59
A00562,2024-05-05,32,23,32,87
A00563,2024-04-25,40,32,29,101
A00564,2024-05-28,35,25,11,71
A00565,2024-02-18,19,24,25,68
A00566,2024-09-19,36,39,20,95
A00567,2024-11-17,11,18,24,53
A00568,2024-05-24,19,12,26,57
A00569,2024-01-29,19,19,28,66
A00570,2024-09-11,33,24,29,86
A00571,2023-12-13,23,34,12,69
A00572,2024-07-27,22,34,15,71
A00573,2024-01-28,35,17,32,84
A00574,2024-04-04,26,13,13,52
A00575,2024-04-11,30,11,17,58
A00576,2024-07-18,40,28,13,81
A00577,2024-10-30,16,33,31,80
A00578,2024-12-01,36,37,13,86
A00579,2024-06-13,18,10,23,51
A00580,2024-11-22,17,25,12,54
A00581,2024-08-17,27,15,24,66
A00582,2024-05-25,28,31,10,69
A00583,2024-05-26,13,29,40,82
A00584,2024-07-18,37,27,32,96
A00585,2024-01-10,40,29,17,86
A00586,2024-05-15,22,27,31,80
A00587,2024-03-02,21,14,27,62
A00588,2024-11-16,12,21,18,51
A00589,2024-02-12,13,31,28,72
A00590,2024-04-12,22,17,13,52
A00591,2024-09-02,15,35,20,70
A00592,2024-06-19,37,19,25,81
A00593,2023-12-19,19,24,37,80
A00594,2024-02-24,35,18,34,87
A00595,2024-10-25,15,25,32,72
A00596,2024-11-01,27,23,31,81
A00597,2024-02-03,38,13,32,83
A00598,2024-11-06,26,36,34,96
A00599,2024-03-25,35,24,32,91
A00600,2023-12-11,21,39,18,78
A00601,2024-11-30,19,10,26,55
A00602,2024-06-01,36,36,40,112
A00603,2024-02-13,25,20,29,74
A00604,2024-02-19,26,29,25,80
A00605,2024-03-13,12,14,18,44
A00606,2024-08-30,36,34,13,83
A00607,2024-10-21,25,22,17,64
A00608,2024-09-16,24,16,34,74
A00609,2024-11-30,27,31,28,86
A00610,2024-06-26,28,35,11,74
A00611,2023-12-27,20,25,26,71
A00612,2024-09-25,23,15,39,77
A00613,2023-12-14,24,13,23,60
A00614,2024-11-17,21,24,22,67
A00615,2024-09-01,16,20,31,67
A00616,2024-01-04,36,21,40,97
A00617,2024-01-12,40,39,29,108
A00618,2024-01-20,18,37,37,92
A00619,2023-12-10,11,19,22,52
A00620,2024-05-10,40,22,19,81
A00621,2024-08-21,39,16,24,79
A00622,2024-10-14,31,12,26,69
A00623,2024-03-28,26,17,20,63
A00624,2024-04-29,19,14,16,49
A00625,2024-07-06,34,26,28,88
A00626,2024-06-28,16,40,19,75
A00627,2024-01-30,10,28,25,63
A00628,2024-10-12,24,29,38,91
A00629,2024-04-29,13,17,22,52
A00630,2024-01-24,36,27,34,97
A00631,2024-06-17,37,23,32,92
A00632,2024-07-23,30,20,29,79
A00633,2024-07-29,32,31,26,89
A00634,2024-01-25,28,39,24,91
A00635,2024-01-24,20,37,28,85
A00636,2024-09-09,23,10,40,73
A00637,2024-09-21,18,28,16,62
A00638,2024-08-13,32,36,15,83
A00639,2024-04-16,26,31,14,71
A00640,2024-11-06,10,18,19,47
A00641,2024-04-17,32,21,16,69
A00642,2024-10-02,19,22,15,56
A00643,2024-09-11,18,36,13,67
A00644,2024-04-20,19,34,21,74
A00645,2024-04-28,23,17,28,68
A00646,2024-10-02,11,27,22,60
A00647,2024-03-01,37,31,13,81
A00648,2024-09-15,20,10,17,47
A00649,2024-01-20,31,40,23,94
A00650,2024-02-29,31,37,11,79
A00651,2024-11-01,10,14,16,40
A00652,2024-02-22,39,13,28,80
A00653,2024-07-26,22,27,21,70
A00654,2024-08-30,39,21,33,93
A00655,2024-08-20,12,20,31,63
A00656,2024-01-03,33,36,16,85
A00657,2024-10-19,35,28,39,102
A00658,2024-09-25,38,38,36,112
A00659,2024-01-22,37,37,14,88
A00660,2024-03-31,24,38,33,95
A00661,2024-05-20,27,16,34,77
A00662,2024-01-18,14,27,21,62
A00663,2024-04-03,15,13,12,40
A00664,2024-01-19,37,27,39,103
A00665,2024-10-13,30,22,25,77
A00666,2024-11-08,11,33,17,61
A00667,2023-12-27,18,27,11,56
A00668,2024-05-01,17,14,12,43
A00669,2024-06-19,40,36,26,102
A00670,2024-05-08,34,24,15,73
A00671,2024-07-06,28,18,18,64
A00672,2024-04-30,23,24,16,63
A00673,2024-04-21,11,21,15,47
A00674,2024-03-02,34,37,34,105
A00675,2024-10-27,21,39,21,81
A00676,2024-09-03,35,35,29,99
A00677,2023-12-19,15,22,11,48
A00678,2024-09-02,40,37,14,91
A00679,2024-08-18,32,19,25,76
A00680,2024-04-21,10,27,31,68
A00681,2024-01-23,23,30,22,75
A00682,2024-05-28,15,28,32,75
A00683,2024-04-17,16,24,21,61
A00684,2024-05-06,17,25,11,53
A00685,2024-03-27,17,25,32,74
A00686,2024-04-28,15,12,12,39
A00687,2024-03-27,28,16,27,71
A00688,2024-01-20,26,32,39,97
A00689,2024-09-26,10,32,14,56
A00690,2023-12-23,10,33,20,63
A00691,2024-02-11,21,15,16,52
A00692,2024-11-29,37,21,26,84
A00693,2024-11-26,16,13,21,50
A00694,2024-12-03,16,36,15,67
A00695,2024-11-30,17,19,39,75
A00696,2024-01-10,25,38,28,91
A00697,2024-05-12,30,27,38,95
A00698,2024-07-17,37,37,20,94
A00699,2024-11-22,36,30,33,99
A00700,2023-12-15,27,30,11,68
A00701,2024-04-27,20,30,13,63
A00702,2024-10-10,21,16,24,61
A00703,2024-04-17,24,25,29,78
A00704,2024-03-18,35,17,37,89
A00705,2023-12-13,31,16,27,74
A00706,2024-08-27,14,12,37,63
A00707,2024-09-11,37,22,32,91
A00708,2024-09-13,23,35,23,81
A00709,2024-01-10,14,23,13,50
A00710,2024-03-11,15,26,31,72
A00711,2024-02-27,12,36,10,58
A00712,2023-12-25,10,16,22,48
A00713,2024-09-02,27,20,18,65
A00714,2024-10-02,29,32,24,85
A00715,2024-11-01,21,24,22,67
A00716,2024-05-10,15,27,12,54
A00717,2024-05-12,18,18,19,55
A00718,2024-03-10,28,20,20,68
A00719,2024-06-23,17,39,32,88
A00720,2024-06-11,30,20,22,72
A00721,2024-06-08,27,35,39,101
A00722,2024-11-24,34,10,31,75
A00723,2024-04-05,15,34,33,82
A00724,2024-07-02,40,34,24,98
A00725,2024-03-12,37,31,20,88
A00726,2024-09-09,19,40,39,98
A00727,2024-04-08,35,17,16,68
A00728,2024-06-06,25,13,36,74
A00729,2024-11-17,39,18,17,74
A00730,2024-07-19,25,33,34,92
A00731,2024-03-30,20,27,10,57
A00732,2024-10-25,27,19,29,75
A00733,2024-08-28,29,32,21,82
A00734,2024-10-31,11,40,32,83
A00735,2024-06-15,28,40,34,102
A00736,2024-11-09,24,16,15,55
A00737,2024-12-05,21,39,27,87
A00738,2024-09-24,33,18,17,68
A00739,2024-09-27,34,32,21,87
A00740,2023-12-22,40,36,19,95
A00741,2024-09-14,28,35,36,99
A00742,2024-06-14,24,22,12,58
A00743,2024-08-15,38,38,30,106
A00744,2024-06-15,19,20,19,58
A00745,2024-06-24,34,11,19,64
A00746,2024-01-20,39,10,39,88
A00747,2024-06-07,19,16,32,67
A00748,2024-08-25,24,12,39,75
A00749,2024-08-20,10,22,16,48
A00750,2024-05-20,39,29,39,107
A00751,2024-04-04,31,34,18,83
A00752,2024-10-01,29,35,34,98
A00753,2024-05-09,14,25,11,50
A00754,2024-05-21,32,15,26,73
A00755,2024-01-08,10,13,33,56
A00756,2024-05-02,22,14,28,64
A00757,2024-05-28,34,17,29,80
A00758,2024-10-08,39,22,23,84
A00759,2024-01-12,11,36,29,76
A00760,2024-09-13,34,26,14,74
A00761,2024-07-31,19,37,26,82
A00762,2024-09-20,38,18,10,66
A00763,2024-02-29,14,28,12,54
A00764,2024-09-27,20,12,23,55
A00765,2024-02-01,34,22,21,77
A00766,2024-05-15,18,16,10,44
A00767,2024-03-24,23,33,12,68
A00768,2024-03-24,10,25,39,74
A00769,2024-06-25,38,33,29,100
A00770,2024-06-19,32,17,26,75
A00771,2024-05-02,33,29,33,95
A00772,2024-01-20,33,11,21,65
A00773,2024-07-23,17,36,38,91
A00774,2024-06-18,27,35,10,72
A00775,2024-07-27,16,34,31,81
A00776,2024-08-08,37,31,30,98
A00777,2024-06-10,10,15,20,45
A00778,2023-12-18,27,18,13,58
A00779,2024-07-13,28,29,10,67
A00780,2024-05-31,33,26,18,77
A00781,2024-01-17,30,31,36,97
A00782,2024-02-14,32,11,37,80
A00783,2024-11-25,26,19,13,58
A00784,2024-05-16,40,35,35,110
A00785,2024-07-12,34,33,36,103
A00786,2024-01-10,10,15,21,46
A00787,2024-07-17,14,39,37,90
A00788,2024-09-26,35,19,23,77
A00789,2024-03-11,14,13,13,40
A00790,2024-09-12,37,18,24,79
A00791,2024-01-06,19,23,30,72
A00792,2024-01-15,26,32,23,81
A00793,2024-10-30,24,32,25,81
A00794,2024-07-17,24,30,35,89
A00795,2023-12-10,17,19,10,46
A00796,2024-11-28,15,22,15,52
A00797,2024-07-17,13,38,10,61
A00798,2024-10-26,28,28,31,87
A00799,2024-04-14,10,39,12,61
A00800,2024-03-18,32,18,37,87
A00801,2024-10-27,24,32,12,68
A00802,2024-07-11,36,19,23,78
A00803,2024-06-16,17,34,18,69
A00804,2023-12-29,27,18,21,66
A00805,2024-10-08,14,28,26,68
A00806,2024-07-17,20,26,13,59
A00807,2024-03-07,20,36,18,74
A00808,2024-10-09,20,31,37,88
A00809,2024-11-22,21,26,15,62
A00810,2024-03-25,27,38,11,76
A00811,2024-09-25,39,10,24,73
A00812,2024-05-25,32,30,18,80
A00813,2024-04-23,13,38,10,61
A00814,2024-04-29,18,21,24,63
A00815,2024-09-25,13,25,27,65
A00816,2024-11-21,15,21,26,62
A00817,2023-12-11,20,16,34,70
A00818,2024-03-26,19,35,19,73
A00819,2024-05-05,13,39,37,89
A00820,2024-03-27,30,17,22,69
A00821,2024-05-16,14,24,40,78
A00822,2024-10-01,11,18,28,57
A00823,2024-03-03,17,34,29,80
A00824,2024-08-20,21,27,22,70
A00825,2024-08-29,37,38,27,102
A00826,2024-07-29,19,37,31,87
A00827,2024-03-22,37,14,27,78
A00828,2024-09-03,39,19,33,91
A00829,2024-10-11,16,10,37,63
A00830,2023-12-24,15,24,27,66
A00831,2024-10-04,34,39,28,101
A00832,2024-01-11,31,35,11,77
A00833,2024-03-30,21,27,23,71
A00834,2024-10-04,40,19,29,88
A00835,2024-10-21,37,39,19,95
A00836,2024-06-17,27,33,26,86
A00837,2024-06-15,18,37,13,68
A00838,2024-06-04,25,25,14,64
A00839,2024-03-30,21,32,17,70
A00840,2024-03-01,17,27,24,68
A00841,2024-02-05,17,35,34,86
A00842,2024-10-16,35,28,17,80
A00843,2024-07-20,38,23,33,94
A00844,2024-04-08,24,10,11,45
A00845,2024-03-18,35,17,11,63
A00846,2024-08-09,39,10,22,71
A00847,2024-09-07,37,16,25,78
A00848,2024-09-25,29,30,10,69
A00849,2024-10-22,33,35,23,91
A00850,2024-05-01,38,29,25,92
A00851,2024-08-25,17,25,14,56
A00852,2024-10-11,36,24,23,83
A00853,2024-02-02,18,20,24,62
A00854,2024-01-22,18,22,18,58
A00855,2024-09-04,23,28,34,85
A00856,2024-09-17,20,24,24,68
A00857,2024-12-08,34,18,27,79
A00858,2024-09-28,25,37,24,86
A00859,2024-06-22,18,19,37,74
A00860,2024-01-26,34,24,16,74
A00861,2024-08-22,39,40,26,105
A00862,2024-10-21,19,36,12,67
A00863,2024-09-23,34,40,28,102
A00864,2024-01-20,23,40,12,75
A00865,2024-11-29,32,26,26,84
A00866,2024-05-28,15,26,40,81
A00867,2024-01-02,13,27,16,56
A00868,2024-03-15,27,23,38,88
A00869,2024-02-12,34,26,13,73
A00870,2024-12-05,25,33,36,94
A00871,2024-06-12,27,13,34,74
A00872,2024-10-24,20,22,31,73
A00873,2024-03-26,22,32,23,77
A00874,2024-06-17,15,31,16,62
A00875,2024-11-09,15,23,30,68
A00876,2024-05-03,20,30,30,80
A00877,2024-01-12,10,24,10,44
A00878,2024-10-22,36,28,26,90
A00879,2024-01-10,23,32,12,67
A00880,2024-01-15,20,33,38,91
A00881,2024-05-29,38,30,37,105
A00882,2024-08-24,23,16,40,79
A00883,2024-01-11,34,14,25,73
A00884,2024-07-22,10,28,29,67
A00885,2024-04-14,17,35,24,76
A00886,2024-07-18,40,29,34,103
A00887,2024-12-08,10,36,22,68
A00888,2024-05-28,31,21,31,83
A00889,2024-02-21,29,33,35,97
A00890,2024-07-12,35,37,17,89
A00891,2024-10-30,24,21,34,79
A00892,2023-12-29,23,31,29,83
A00893,2024-01-02,15,24,32,71
A00894,2024-10-10,11,27,33,71
A00895,2024-07-14,10,37,22,69
A00896,2024-09-10,37,16,28,81
A00897,2024-12-04,35,13,38,86
A00898,2024-05-16,15,20,24,59
A00899,2024-07-20,38,17,19,74
A00900,2024-06-15,14,27,32,73
A00901,2024-05-01,31,35,24,90
A00902,2024-03-11,34,26,16,76
A00903,2024-06-21,17,14,36,67
A00904,2023-12-31,28,21,20,69
A00905,2024-05-26,36,32,39,107
A00906,2024-04-23,11,25,17,53
A00907,2024-05-06,10,27,20,57
A00908,2024-09-07,15,38,17,70
A00909,2024-06-24,40,21,36,97
A00910,2024-07-07,15,11,25,51
A00911,2024-10-18,23,14,33,70
A00912,2024-02-17,23,14,32,69
A00913,2024-10-11,33,14,17,64
A00914,2024-06-14,27,32,22,81
A00915,2024-10-24,13,31,15,59
A00916,2024-10-11,31,11,35,77
A00917,2024-11-06,30,13,39,82
A00918,2024-01-30,39,29,39,107
A00919,2024-11-28,20,25,38,83
A00920,2024-11-29,35,23,26,84
A00921,2023-12-14,14,38,22,74
A00922,2024-11-02,22,21,35,78
A00923,2024-07-28,30,31,28,89
A00924,2024-05-13,26,21,32,79
A00925,2024-05-23,14,36,38,88
A00926,2024-03-09,23,12,33,68
A00927,2024-05-09,20,37,35,92
A00928,2024-01-07,13,40,21,74
A00929,2024-09-03,28,40,16,84
A00930,2024-12-06,10,30,11,51
A00931,2024-07-18,29,31,39,99
A00932,2023-12-27,33,35,40,108
A00933,2024-11-16,23,27,33,83
A00934,2024-09-11,16,20,11,47
A00935,2024-11-15,33,15,25,73
A00936,2024-07-29,22,34,39,95
A00937,2024-04-01,33,29,40,102
A00938,2024-02-06,31,21,16,68
A00939,2024-11-16,12,23,30,65
A00940,2024-03-22,16,28,10,54
A00941,2024-02-21,26,36,19,81
A00942,2024-02-02,13,25,36,74
A00943,2024-08-12,16,13,13,42
A00944,2024-11-06,24,13,21,58
A00945,2024-11-28,18,36,39,93
A00946,2024-09-08,35,18,12,65
A00947,2024-05-20,11,26,17,54
A00948,2024-02-05,26,22,31,79
A00949,2024-03-17,31,25,20,76
A00950,2024-10-14,11,24,15,50
A00951,2024-01-05,14,23,28,65
A00952,2024-02-14,30,28,21,79
A00953,2024-02-25,26,28,10,64
A00954,2024-05-12,29,10,40,79
A00955,2024-03-21,29,22,12,63
A00956,2024-11-29,34,40,38,112
A00957,2024-11-19,18,11,38,67
A00958,2024-10-16,23,13,12,48
A00959,2024-03-22,33,17,10,60
A00960,2024-09-03,16,20,32,68
A00961,2024-08-15,35,25,19,79
A00962,2024-02-05,37,16,12,65
A00963,2024-07-07,21,13,25,59
A00964,2024-08-16,17,11,32,60
A00965,2024-10-30,32,35,10,77
A00966,2024-08-07,10,29,28,67
A00967,2024-05-18,40,35,30,105
A00968,2024-11-28,11,15,20,46
A00969,2024-03-23,38,11,24,73
A00970,2024-05-25,35,18,17,70
A00971,2024-08-11,25,38,35,98
A00972,2024-08-17,13,38,35,86
A00973,2024-04-26,23,24,34,81
A00974,2024-05-28,34,23,27,84
A00975,2024-05-19,14,32,26,72
A00976,2024-06-15,37,27,21,85
A00977,2024-04-30,35,15,27,77
A00978,2024-11-02,12,36,32,80
A00979,2024-05-19,18,33,16,67
A00980,2024-05-17,25,32,35,92
A00981,2024-03-13,19,39,18,76
A00982,2024-03-02,27,23,26,76
A00983,2024-11-26,15,29,15,59
A00984,2024-03-19,33,24,35,92
A00985,2024-07-19,39,12,35,86
A00986,2024-07-03,36,38,29,103
A00987,2024-03-10,34,34,15,83
A00988,2024-03-16,30,31,31,92
A00989,2024-07-25,17,29,34,80
A00990,2024-07-28,39,30,31,100
A00991,2024-04-07,15,16,37,68
A00992,2024-09-25,32,29,36,97
A00993,2024-08-25,14,37,28,79
A00994,2024-10-12,33,27,24,84
A00995,2024-07-18,40,27,39,106
A00996,2024-02-18,18,15,10,43
A00997,2024-09-01,24,25,24,73
A00998,2024-03-23,19,28,39,86
A00999,2024-10-01,20,28,26,74
A01000,2024-01-22,20,28,34,82
A01001,2024-08-18,14,40,37,91
A01002,2024-08-09,19,30,13,62
A01003,2024-08-26,26,25,32,83
A01004,2024-09-30,10,37,19,66
A01005,2024-08-19,15,32,26,73
A01006,2024-02-19,26,24,30,80
A01007,2024-04-14,22,24,16,62
A01008,2023-12-14,31,11,32,74
A01009,2024-01-05,26,11,13,50
A01010,2024-09-02,19,25,12,56
A01011,2024-01-06,28,27,34,89
A01012,2024-05-09,27,21,31,79
A01013,2024-09-17,37,40,35,112
A01014,2024-06-28,34,19,31,84
A01015,2024-10-19,17,26,34,77
A01016,2024-10-29,33,35,20,88
A01017,2023-12-20,13,22,19,54
A01018,2024-05-26,29,37,11,77
A01019,2024-09-16,36,24,12,72
A01020,2023-12-29,39,14,26,79
A01021,2024-09-18,18,16,39,73
A01022,2024-06-21,32,30,13,75
A01023,2024-04-18,11,33,29,73
A01024,2024-10-28,29,18,12,59
A01025,2024-02-27,27,34,10,71
A01026,2024-05-10,10,24,32,66
A01027,2024-02-06,23,19,22,64
A01028,2024-12-03,24,23,25,72
A01029,2024-05-22,15,32,18,65
A01030,2024-06-16,31,19,28,78
A01031,2024-11-15,17,25,33,75
A01032,2024-02-11,17,30,33,80
A01033,2024-03-20,21,13,31,65
A01034,2024-02-22,28,20,27,75
A01035,2024-08-20,10,33,32,75
A01036,2024-01-07,23,21,13,57
A01037,2024-07-12,22,12,19,53
A01038,2024-11-13,37,38,30,105
A01039,2024-02-11,37,37,19,93
A01040,2024-06-05,29,20,12,61
A01041,2024-06-27,25,16,30,71
A01042,2024-10-30,16,38,33,87
A01043,2024-03-29,12,40,19,71
A01044,2024-07-08,37,38,36,111
A01045,2024-06-15,37,38,28,103
A01046,2024-09-22,25,18,21,64
A01047,2024-02-24,34,22,19,75
A01048,2024-09-14,32,19,30,81
A01049,2024-02-27,26,26,40,92
A01050,2024-06-29,38,19,22,79
A01051,2024-03-31,35,35,10,80
A01052,2023-12-30,22,28,37,87
A01053,2024-06-04,31,28,10,69
A01054,2024-08-27,22,12,33,67
A01055,2024-05-03,35,32,33,100
A01056,2024-08-22,32,13,15,60
A01057,2024-07-01,27,34,15,76
A01058,2024-02-27,11,12,21,44
A01059,2024-09-22,17,33,20,70
A01060,2024-03-31,35,33,40,108
A01061,2024-03-16,19,15,20,54
A01062,2024-08-08,12,30,39,81
A01063,2024-11-10,37,33,10,80
A01064,2024-11-22,20,29,28,77
A01065,2024-05-05,20,21,25,66
A01066,2024-03-02,13,27,37,77
A01067,2024-04-26,16,29,39,84
A01068,2023-12-26,37,32,21,90
A01069,2024-02-18,11,38,20,69
A01070,2024-10-25,31,39,11,81
A01071,2024-09-29,32,40,32,104
A01072,2023-12-30,31,19,29,79
A01073,2024-08-11,17,38,19,74
A01074,2024-09-13,32,33,13,78
A01075,2024-08-14,34,35,18,87
A01076,2024-08-27,17,10,32,59
A01077,2024-11-09,20,12,30,62
A01078,2024-09-18,28,37,13,78
A01079,2024-05-04,11,10,13,34
A01080,2024-09-29,12,23,16,51
A01081,2024-11-05,39,38,27,104
A01082,2024-02-22,28,13,22,63
A01083,2024-04-29,33,30,39,102
A01084,2024-03-31,14,13,32,59
A01085,2024-11-04,11,34,18,63
A01086,2024-11-06,13,34,30,77
A01087,2024-09-17,26,28,22,76
A01088,2024-07-11,28,22,23,73
A01089,2024-09-20,23,12,27,62
A01090,2024-06-27,24,15,24,63
A01091,2024-10-15,16,26,29,71
A01092,2024-08-29,40,29,11,80
A01093,2024-07-01,23,24,21,68
A01094,2024-08-19,11,20,40,71
A01095,2024-04-05,32,39,32,103
A01096,2024-08-11,15,15,18,48
A01097,2024-01-28,40,26,35,101
A01098,2024-08-23,19,21,24,64
A01099,2024-01-16,25,26,25,76
A01100,2024-04-12,20,29,39,88
A01101,2024-05-16,13,32,19,64
A01102,2024-11-17,19,27,17,63
A01103,2024-11-18,30,12,18,60
A01104,2023-12-29,36,12,18,66
A01105,2024-09-03,11,31,25,67
A01106,2024-10-19,34,20,26,80
A01107,2024-06-29,28,28,37,93
A01108,2024-06-18,38,12,20,70
A01109,2024-08-25,10,12,39,61
A01110,2024-01-26,12,36,30,78
A01111,2024-10-04,25,15,30,70
A01112,2024-07-22,21,29,10,60
A01113,2024-05-10,32,39,38,109
A01114,2024-03-28,24,37,21,82
A01115,2024-10-25,15,12,30,57
A01116,2024-10-04,16,10,20,46
A01117,2024-06-02,29,34,11,74
A01118,2024-03-05,22,36,37,95
A01119,2023-12-31,33,24,13,70
A01120,2024-03-19,29,16,31,76
A01121,2024-07-13,35,27,33,95
A01122,2024-11-12,23,10,15,48
A01123,2024-04-25,33,10,17,60
A01124,2024-06-26,14,16,35,65
A01125,2024-06-01,30,13,13,56
A01126,2024-09-24,12,23,11,46
A01127,2024-03-14,15,19,20,54
A01128,2023-12-29,23,40,40,103
A01129,2024-02-19,13,15,39,67
A01130,2024-11-28,26,28,18,72
A01131,2024-03-04,27,37,32,96
A01132,2024-08-07,30,21,11,62
A01133,2024-07-17,22,11,38,71
A01134,2024-05-19,14,11,30,55
A01135,2024-08-07,26,20,15,61
A01136,2024-05-18,10,25,35,70
A01137,2024-10-11,13,16,40,69
A01138,2024-02-24,34,21,13,68
A01139,2024-05-04,33,22,11,66
A01140,2024-06-05,19,21,33,73
A01141,2024-09-14,32,36,21,89
A01142,2024-06-09,26,11,26,63
A01143,2024-07-29,29,17,18,64
A01144,2024-05-25,17,22,34,73
A01145,2024-01-29,20,35,36,91
A01146,2024-02-01,32,17,16,65
A01147,2024-04-19,17,33,17,67
A01148,2024-02-14,31,14,16,61
A01149,2024-11-16,21,11,35,67
A01150,2024-01-11,33,30,37,100
A01151,2024-07-13,33,37,15,85
A01152,2024-09-25,38,21,17,76
A01153,2024-02-17,28,37,38,103
A01154,2024-09-18,15,28,33,76
A01155,2024-06-21,25,31,16,72
A01156,2024-07-24,31,28,36,95
A01157,2023-12-23,30,24,35,89
A01158,2024-09-05,21,17,23,61
A01159,2024-03-11,40,10,18,68
A01160,2024-06-14,31,23,37,91
A01161,2024-11-16,14,19,26,59
A01162,2024-01-04,13,12,20,45
A01163,2024-05-04,11,37,23,71
A01164,2024-05-21,10,29,36,75
A01165,2024-01-11,20,17,25,62
A01166,2024-08-13,31,36,32,99
A01167,2024-08-05,12,40,37,89
A01168,2024-10-15,37,16,14,67
A01169,2024-05-01,34,36,19,89
A01170,2024-12-09,35,33,34,102
A01171,2024-02-18,33,11,25,69
A01172,2024-05-30,32,34,12,78
A01173,2024-02-02,10,40,15,65
A01174,2024-05-02,21,16,26,63
A01175,2024-07-25,34,31,10,75
A01176,2024-01-28,31,22,21,74
A01177,2024-02-16,16,38,28,82
A01178,2024-04-06,26,40,24,90
A01179,2024-07-25,39,23,20,82
A01180,2024-03-10,33,15,18,66
A01181,2024-01-23,19,36,26,81
A01182,2024-04-15,34,11,28,73
A01183,2024-11-08,33,30,26,89
A01184,2024-03-04,21,39,25,85
A01185,2023-12-15,21,19,15,55
A01186,2024-11-14,38,16,34,88
A01187,2024-05-27,38,29,22,89
A01188,2024-07-16,35,31,11,77
A01189,2024-01-20,39,20,24,83
A01190,2024-04-23,32,10,13,55
A01191,2024-03-31,26,38,26,90
A01192,2024-05-23,28,18,11,57
A01193,2024-08-06,37,20,11,68
A01194,2024-10-14,14,20,28,62
A01195,2024-10-16,15,15,28,58
A01196,2024-06-21,28,23,12,63
A01197,2024-02-21,13,10,29,52
A01198,2024-08-01,33,14,35,82
A01199,2024-05-09,14,15,14,43
A01200,2024-04-30,23,19,32,74
A01201,2024-06-04,20,31,23,74
A01202,2024-03-24,13,36,24,73
A01203,2024-01-25,13,38,16,67
A01204,2024-09-30,11,19,24,54
A01205,2024-04-15,33,16,18,67
A01206,2024-08-17,14,39,40,93
A01207,2024-09-04,11,20,34,65
A01208,2024-11-22,14,39,34,87
A01209,2024-06-29,10,23,21,54
A01210,2023-12-20,14,21,29,64
A01211,2024-01-17,32,30,34,96
A01212,2024-02-01,18,40,37,95
A01213,2024-10-12,28,36,19,83
A01214,2024-04-16,11,32,12,55
A01215,2024-04-16,26,17,14,57
A01216,2024-04-09,24,38,24,86
A01217,2024-07-26,23,35,29,87
A01218,2024-11-19,17,32,12,61
A01219,2024-12-08,32,37,31,100
A01220,2024-01-13,14,10,27,51
A01221,2024-10-31,31,17,19,67
A01222,2024-09-22,20,32,34,86
A01223,2024-04-12,11,10,33,54
A01224,2024-09-24,33,19,35,87
A01225,2024-01-17,24,33,36,93
A01226,2024-08-14,12,32,40,84
A01227,2024-07-17,37,28,30,95
A01228,2024-01-12,29,27,11,67
A01229,2024-10-06,16,33,32,81
A01230,2024-01-10,36,16,18,70
A01231,2024-12-09,29,28,22,79
A01232,2024-06-08,13,21,28,62
A01233,2024-08-08,25,12,20,57
A01234,2024-06-04,13,14,36,63
A01235,2024-03-24,12,39,28,79
A01236,2024-11-02,29,17,27,73
A01237,2024-09-10,39,37,37,113
A01238,2024-06-19,38,31,10,79
A01239,2024-08-17,18,10,40,68
A01240,2024-01-02,33,14,19,66
A01241,2024-03-10,26,18,24,68
A01242,2023-12-14,24,14,38,76
A01243,2024-07-14,12,31,19,62
A01244,2024-07-07,37,10,12,59
A01245,2024-02-03,14,21,19,54
A01246,2024-09-21,19,10,19,48
A01247,2024-01-22,11,38,28,77
A01248,2024-07-13,36,11,24,71
A01249,2024-08-28,35,30,15,80
A01250,2024-02-07,24,33,16,73
A01251,2024-09-18,28,25,32,85
A01252,2024-03-06,39,33,37,109
A01253,2024-06-08,18,18,22,58
A01254,2024-01-22,25,30,30,85
A01255,2024-07-07,11,35,17,63
A01256,2024-03-05,26,21,11,58
A01257,2024-10-12,28,21,34,83
A01258,2024-06-23,31,28,29,88
A01259,2024-07-30,18,18,24,60
A01260,2024-12-05,40,10,21,71
A01261,2024-09-17,39,12,25,76
A01262,2024-04-27,36,12,11,59
A01263,2024-06-30,34,16,38,88
A01264,2024-08-21,33,38,38,109
A01265,2024-11-21,20,11,22,53
A01266,2024-02-24,10,14,27,51
A01267,2023-12-22,12,37,19,68
A01268,2024-09-24,24,32,11,67
A01269,2024-01-25,28,24,12,64
A01270,2024-07-12,14,29,27,70
A01271,2024-03-26,18,35,40,93
A01272,2024-02-26,25,36,19,80
A01273,2024-08-20,31,29,40,100
A01274,2024-04-15,38,19,22,79
A01275,2024-10-10,30,26,34,90
A01276,2024-01-13,40,33,37,110
A01277,2024-09-15,40,20,13,73
A01278,2024-02-11,22,18,40,80
A01279,2024-03-10,23,30,10,63
A01280,2024-02-25,17,37,40,94
A01281,2024-08-24,26,25,32,83
A01282,2023-12-26,30,14,11,55
A01283,2023-12-19,29,24,13,66
A01284,2024-05-14,12,32,39,83
A01285,2024-02-24,10,33,12,55
A01286,2024-11-12,36,26,22,84
A01287,2024-04-22,30,14,25,69
A01288,2024-08-08,33,24,13,70
A01289,2024-11-04,23,29,22,74
A01290,2024-03-24,26,27,24,77
A01291,2024-08-20,30,36,40,106
A01292,2024-06-25,33,34,37,104
A01293,2024-01-05,13,18,15,46
A01294,2024-03-09,23,18,31,72
A01295,2024-08-02,37,31,18,86
A01296,2024-07-11,40,17,23,80
A01297,2024-04-11,24,37,18,79
A01298,2024-05-03,12,17,14,43
A01299,2024-05-07,10,33,37,80
A01300,2024-03-28,20,22,22,64
A01301,2024-09-29,15,34,15,64
A01302,2024-05-06,29,14,26,69
A01303,2024-03-26,21,38,31,90
A01304,2024-09-25,20,19,15,54
A01305,2024-02-03,40,29,27,96
A01306,2024-05-11,16,12,28,56
A01307,2024-05-26,34,12,33,79
A01308,2024-01-27,11,22,13,46
A01309,2024-09-06,40,15,17,72
A01310,2024-07-23,23,12,17,52
A01311,2024-11-07,16,19,16,51
A01312,2024-04-22,13,40,38,91
A01313,2023-12-31,16,14,23,53
A01314,2024-03-18,31,39,33,103
A01315,2024-10-09,16,35,35,86
A01316,2024-03-14,28,15,21,64
A01317,2024-11-04,10,32,10,52
A01318,2024-04-28,38,20,15,73
A01319,2024-09-18,11,13,20,44
A01320,2024-10-09,21,38,29,88
A01321,2024-07-18,33,17,30,80
A01322,2024-01-23,27,26,38,91
A01323,2024-08-02,20,38,25,83
A01324,2024-01-04,19,28,27,74
A01325,2024-07-03,19,22,30,71
A01326,2023-12-22,12,38,17,67
A01327,2024-11-17,35,28,15,78
A01328,2024-12-03,30,11,33,74
A01329,2024-08-09,22,18,37,77
A01330,2024-07-05,15,37,31,83
A01331,2024-05-24,13,30,40,83
A01332,2023-12-14,12,17,26,55
A01333,2024-08-11,14,23,28,65
A01334,2024-06-26,35,18,27,80
A01335,2024-01-22,38,36,35,109
A01336,2024-10-06,33,15,39,87
A01337,2024-03-24,27,23,37,87
A01338,2024-08-30,30,34,35,99
A01339,2024-02-15,35,25,28,88
A01340,2024-02-24,32,21,23,76
A01341,2024-03-28,37,39,31,107
A01342,2024-04-23,36,40,29,105
A01343,2024-08-26,30,18,37,85
A01344,2024-03-11,15,29,27,71
A01345,2024-02-28,25,19,22,66
A01346,2024-01-04,32,35,14,81
A01347,2024-10-11,10,18,39,67
A01348,2024-02-14,30,23,20,73
A01349,2024-05-11,12,21,40,73
A01350,2024-03-30,24,38,22,84
A01351,2024-09-05,18,26,13,57
A01352,2024-11-01,32,35,19,86
A01353,2024-01-04,35,19,22,76
A01354,2024-02-04,40,34,11,85
A01355,2024-06-06,17,35,15,67
A01356,2024-11-24,24,13,25,62
A01357,2024-01-27,15,18,18,51
A01358,2024-03-04,18,31,22,71
A01359,2024-11-10,36,19,40,95
A01360,2023-12-20,34,13,29,76
A01361,2024-01-13,23,13,34,70
A01362,2024-08-01,34,34,38,106
A01363,2024-06-06,18,40,28,86
A01364,2024-11-28,35,22,10,67
A01365,2024-12-08,40,33,11,84
A01366,2024-07-24,10,22,13,45
A01367,2024-12-07,18,25,33,76
A01368,2024-06-12,35,39,13,87
A01369,2024-07-19,35,36,35,106
A01370,2024-07-07,10,35,37,82
A01371,2024-02-15,30,21,14,65
A01372,2024-01-12,26,30,10,66
A01373,2024-09-25,39,36,16,91
A01374,2024-04-27,38,17,20,75
A01375,2024-10-06,19,11,40,70
A01376,2024-07-25,40,37,18,95
A01377,2024-05-12,37,26,19,82
A01378,2024-01-21,17,23,25,65
A01379,2024-05-19,12,22,40,74
A01380,2024-02-16,15,28,40,83
A01381,2024-01-06,31,37,17,85
A01382,2024-01-11,26,30,18,74
A01383,2024-08-17,23,22,15,60
A01384,2024-06-12,29,23,25,77
A01385,2024-06-21,35,33,20,88
A01386,2024-09-28,16,17,27,60
A01387,2024-09-16,16,34,22,72
A01388,2024-05-19,25,19,29,73
A01389,2024-07-03,29,20,26,75
A01390,2024-07-14,38,11,38,87
A01391,2024-05-05,27,34,34,95
A01392,2024-07-10,26,12,21,59
A01393,2024-06-17,18,29,25,72
A01394,2024-02-17,13,31,17,61
A01395,2024-01-30,11,40,10,61
A01396,2024-10-03,21,18,23,62
A01397,2024-01-04,34,22,18,74
A01398,2023-12-20,23,34,23,80
A01399,2024-07-24,37,12,12,61
A01400,2024-09-05,20,38,18,76
A01401,2024-09-05,28,12,16,56
A01402,2024-05-27,14,16,36,66
A01403,2024-05-26,36,23,15,74
A01404,2024-06-03,38,34,32,104
A01405,2024-04-18,18,32,33,83
A01406,2024-02-04,17,25,33,75
A01407,2024-11-20,22,12,16,50
A01408,2024-07-21,17,23,29,69
A01409,2024-05-22,24,27,10,61
A01410,2024-01-09,13,40,11,64
A01411,2024-06-30,40,18,14,72
A01412,2024-08-26,31,26,26,83
A01413,2024-03-29,33,13,29,75
A01414,2024-09-02,40,37,33,110
A01415,2024-12-07,15,27,11,53
A01416,2024-04-29,15,30,26,71
A01417,2024-09-05,18,38,32,88
A01418,2024-05-02,34,27,35,96
A01419,2024-02-14,39,33,31,103
A01420,2024-09-29,19,13,35,67
A01421,2024-11-19,20,23,10,53
A01422,2024-10-18,14,35,20,69
A01423,2024-07-09,25,31,31,87
A01424,2024-02-22,33,25,28,86
A01425,2024-06-16,35,36,24,95
A01426,2024-08-04,10,16,34,60
A01427,2024-01-22,19,32,18,69
A01428,2024-07-02,24,33,39,96
A01429,2024-08-28,39,25,12,76
A01430,2024-03-31,23,33,12,68
A01431,2024-11-25,32,35,14,81
A01432,2024-12-07,15,16,38,69
A01433,2024-08-07,31,20,19,70
A01434,2024-05-09,39,35,32,106
A01435,2024-03-03,15,25,24,64
A01436,2024-11-27,40,39,15,94
A01437,2024-04-18,35,14,10,59
A01438,2024-05-10,38,19,21,78
A01439,2024-06-05,36,35,35,106
A01440,2024-05-04,19,32,18,69
A01441,2024-04-13,35,20,19,74
A01442,2024-04-22,30,35,17,82
A01443,2024-09-30,38,22,40,100
A01444,2024-04-06,32,31,36,99
A01445,2024-02-03,13,10,14,37
A01446,2024-10-12,22,38,28,88
A01447,2024-05-28,22,36,32,90
A01448,2024-05-16,37,40,26,103
A01449,2024-08-29,28,21,27,76
A01450,2024-08-04,16,13,32,61
A01451,2024-07-03,31,39,31,101
A01452,2024-02-27,33,28,40,101
A01453,2024-08-21,17,23,39,79
A01454,2024-05-21,35,34,38,107
A01455,2024-02-03,30,33,22,85
A01456,2024-02-24,39,21,21,81
A01457,2024-11-26,34,12,10,56
A01458,2024-01-19,20,36,37,93
A01459,2024-07-29,32,11,12,55
A01460,2024-03-21,12,20,22,54
A01461,2024-05-03,34,13,20,67
A01462,2024-08-07,39,20,18,77
A01463,2024-11-02,12,10,17,39
A01464,2024-12-02,12,11,40,63
A01465,2024-05-02,22,17,10,49
A01466,2024-02-26,38,14,18,70
A01467,2023-12-19,39,16,11,66
A01468,2024-02-17,39,12,17,68
A01469,2024-09-23,32,19,15,66
A01470,2024-02-23,25,10,17,52
A01471,2024-09-07,30,36,19,85
A01472,2024-11-23,33,12,14,59
A01473,2024-11-22,29,33,27,89
A01474,2024-04-23,19,33,15,67
A01475,2024-08-21,35,23,39,97
A01476,2024-10-02,14,22,11,47
A01477,2024-01-12,35,24,35,94
A01478,2024-06-29,24,26,38,88
A01479,2024-10-06,30,22,33,85
A01480,2024-05-04,30,25,39,94
A01481,2024-01-29,33,34,17,84
A01482,2024-02-09,12,30,19,61
A01483,2024-01-09,26,39,29,94
A01484,2024-09-28,13,32,16,61
A01485,2024-08-26,23,39,13,75
A01486,2024-08-17,18,32,20,70
A01487,2024-09-20,21,18,27,66
A01488,2024-01-08,20,33,22,75
A01489,2024-03-09,21,25,30,76
A01490,2024-10-14,29,32,32,93
A01491,2024-10-02,26,20,14,60
A01492,2024-04-24,17,25,33,75
A01493,2024-12-09,24,38,28,90
A01494,2024-05-19,10,22,32,64
A01495,2024-07-22,37,38,36,111
A01496,2024-03-17,34,27,22,83
A01497,2024-04-24,38,36,25,99
A01498,2024-08-05,29,21,21,71
A01499,2024-05-06,31,33,12,76
A01500,2024-10-14,29,20,21,70
A01501,2024-12-08,36,27,24,87
A01502,2024-07-08,24,27,35,86
A01503,2024-08-03,25,36,16,77
A01504,2024-06-12,28,12,15,55
A01505,2024-01-10,38,31,24,93
A01506,2024-01-17,10,31,40,81
A01507,2024-03-06,11,13,25,49
A01508,2024-05-03,10,33,37,80
A01509,2024-03-10,35,27,27,89
A01510,2024-02-25,39,38,10,87
A01511,2024-03-07,26,29,23,78
A01512,2024-08-21,24,20,15,59
A01513,2024-10-15,15,26,13,54
A01514,2024-08-17,23,39,17,79
A01515,2024-09-29,27,28,11,66
A01516,2024-02-01,17,31,37,85
A01517,2024-09-02,31,18,14,63
A01518,2024-08-05,14,10,31,55
A01519,2024-09-16,22,28,14,64
A01520,2024-01-28,10,21,19,50
A01521,2024-02-05,14,20,34,68
A01522,2024-10-17,38,20,23,81
A01523,2024-11-01,24,35,29,88
A01524,2024-05-30,29,18,13,60
A01525,2024-03-25,28,23,36,87
A01526,2024-08-21,18,25,39,82
A01527,2024-09-26,37,13,20,70
A01528,2024-12-06,16,15,20,51
A01529,2024-11-10,38,39,29,106
A01530,2024-05-16,25,10,27,62
A01531,2024-11-18,18,32,11,61
A01532,2024-10-31,11,19,36,66
A01533,2024-01-04,28,30,28,86
A01534,2024-07-16,37,29,31,97
A01535,2024-08-31,30,11,10,51
A01536,2024-01-02,24,16,25,65
A01537,2024-02-14,35,13,17,65
A01538,2024-01-22,12,21,15,48
A01539,2024-03-06,36,15,22,73
A01540,2024-01-12,19,22,28,69
A01541,2024-12-05,27,20,31,78
A01542,2024-09-17,28,28,17,73
A01543,2024-01-01,31,36,33,100
A01544,2024-01-13,27,16,31,74
A01545,2024-07-06,13,17,31,61
A01546,2024-10-07,39,14,28,81
A01547,2024-02-07,33,15,10,58
A01548,2024-08-17,27,32,22,81
A01549,2024-05-18,13,26,26,65
A01550,2024-01-15,39,12,30,81
A01551,2024-11-14,34,36,38,108
A01552,2024-11-22,11,29,21,61
A01553,2024-05-13,12,34,36,82
A01554,2024-03-02,37,37,37,111
A01555,2024-04-19,40,25,28,93
A01556,2024-07-09,19,40,18,77
A01557,2024-03-07,34,24,37,95
A01558,2024-06-19,18,35,26,79
A01559,2024-01-05,15,20,21,56
A01560,2024-12-01,33,13,37,83
A01561,2024-03-21,13,13,15,41
A01562,2024-06-08,29,22,38,89
A01563,2024-02-22,29,33,21,83
A01564,2024-07-20,36,26,32,94
A01565,2024-09-12,38,40,12,90
A01566,2024-10-10,21,37,25,83
A01567,2024-03-30,38,11,31,80
A01568,2024-03-23,26,33,40,99
A01569,2024-03-11,11,17,11,39
A01570,2024-03-13,11,26,25,62
A01571,2024-08-02,36,20,40,96
A01572,2024-07-10,37,29,33,99
A01573,2024-03-07,26,38,36,100
A01574,2024-09-30,33,29,22,84
A01575,2024-03-26,33,35,15,83
A01576,2024-07-10,24,28,32,84
A01577,2024-03-01,17,27,31,75
A01578,2024-05-19,18,39,38,95
A01579,2024-08-24,15,14,11,40
A01580,2024-05-04,18,32,12,62
A01581,2024-11-19,22,26,37,85
A01582,2024-07-26,24,10,15,49
A01583,2024-04-08,30,14,17,61
A01584,2024-05-01,23,22,23,68
A01585,2024-10-05,32,35,15,82
A01586,2024-04-02,26,12,37,75
A01587,2024-02-22,22,32,21,75
A01588,2024-07-07,25,15,12,52
A01589,2024-07-20,11,15,17,43
A01590,2024-03-28,18,38,40,96
A01591,2024-10-31,12,22,25,59
A01592,2024-08-30,11,27,10,48
A01593,2024-10-22,15,27,19,61
A01594,2024-08-23,33,29,23,85
A01595,2024-01-21,17,32,16,65
A01596,2024-03-28,35,39,38,112
A01597,2024-10-07,32,35,35,102
A01598,2024-03-16,25,13,28,66
A01599,2024-03-10,24,34,18,76
A01600,2024-08-09,17,37,30,84
A01601,2023-12-30,21,25,21,67
A01602,2024-04-14,15,17,24,56
A01603,2024-04-05,17,32,22,71
A01604,2024-10-25,13,10,11,34
A01605,2024-08-27,28,17,22,67
A01606,2024-09-26,36,28,32,96
A01607,2024-06-11,37,30,38,105
A01608,2024-06-04,38,24,23,85
A01609,2024-04-28,23,14,11,48
A01610,2024-06-23,30,28,40,98
A01611,2024-09-02,30,16,36,82
A01612,2024-04-03,38,30,23,91
A01613,2024-03-18,24,39,10,73
A01614,2023-12-31,11,29,20,60
A01615,2024-08-09,40,35,17,92
A01616,2024-09-26,13,17,25,55
A01617,2024-08-01,29,32,12,73
A01618,2024-01-29,12,21,37,70
A01619,2024-11-04,14,34,31,79
A01620,2024-10-09,40,12,32,84
A01621,2024-03-01,40,33,38,111
A01622,2024-06-30,38,39,16,93
A01623,2024-10-17,32,28,38,98
A01624,2024-08-03,38,23,20,81
A01625,2024-03-25,25,38,28,91
A01626,2024-08-24,31,34,27,92
A01627,2024-08-10,25,34,24,83
A01628,2023-12-30,14,36,18,68
A01629,2024-01-18,23,28,29,80
A01630,2024-06-27,15,19,25,59
A01631,2024-10-14,39,25,37,101
A01632,2024-04-29,19,37,13,69
A01633,2024-11-17,34,35,32,101
A01634,2024-08-13,17,32,30,79
A01635,2024-09-03,17,14,30,61
A01636,2024-05-29,27,30,28,85
A01637,2024-07-10,39,22,31,92
A01638,2024-10-23,31,10,38,79
A01639,2024-02-08,25,26,35,86
A01640,2024-02-13,11,24,17,52
A01641,2024-05-22,29,11,13,53
A01642,2024-02-24,17,38,36,91
A01643,2024-04-27,21,40,23,84
A01644,2024-04-14,27,29,10,66
A01645,2024-02-15,29,15,14,58
A01646,2024-06-30,40,11,12,63
A01647,2024-03-11,36,14,15,65
A01648,2024-06-08,38,21,37,96
A01649,2024-08-27,10,11,40,61
A01650,2024-06-28,33,16,18,67
A01651,2024-11-23,14,11,22,47
A01652,2023-12-11,26,29,40,95
A01653,2024-07-06,11,13,31,55
A01654,2024-05-22,15,31,31,77
A01655,2024-08-16,23,26,17,66
A01656,2024-04-17,39,36,22,97
A01657,2024-06-13,21,15,12,48
A01658,2023-12-19,26,40,26,92
A01659,2024-07-12,26,37,18,81
A01660,2024-08-02,15,17,10,42
A01661,2024-10-20,36,36,13,85
A01662,2024-01-09,10,12,29,51
A01663,2024-11-05,27,40,14,81
A01664,2023-12-16,26,40,34,100
A01665,2024-11-04,33,11,27,71
A01666,2024-08-26,37,13,30,80
A01667,2024-03-26,37,30,24,91
A01668,2024-05-21,34,17,15,66
A01669,2024-09-07,11,34,32,77
A01670,2024-02-04,25,32,33,90
A01671,2024-05-24,17,38,20,75
A01672,2024-02-09,38,27,11,76
A01673,2024-05-19,30,18,20,68
A01674,2024-06-17,26,20,11,57
A01675,2024-07-30,37,35,30,102
A01676,2024-02-26,23,28,27,78
A01677,2024-01-29,22,15,38,75
A01678,2024-03-18,14,25,31,70
A01679,2024-08-01,28,37,30,95
A01680,2024-03-22,35,23,29,87
A01681,2024-04-03,36,28,28,92
A01682,2024-02-04,11,29,20,60
A01683,2024-08-03,37,23,39,99
A01684,2024-08-27,10,33,37,80
A01685,2024-01-08,27,18,17,62
A01686,2024-02-23,26,20,32,78
A01687,2024-08-16,14,13,31,58
A01688,2024-05-26,16,33,31,80
A01689,2024-11-20,39,30,28,97
A01690,2024-03-16,19,27,34,80
A01691,2024-05-15,22,28,38,88
A01692,2024-02-14,13,23,37,73
A01693,2024-05-09,20,40,19,79
A01694,2024-01-16,16,36,34,86
A01695,2024-10-27,22,36,11,69
A01696,2024-04-19,24,24,32,80
A01697,2024-10-13,35,32,28,95
A01698,2024-11-11,31,33,27,91
A01699,2024-08-27,19,40,10,69
A01700,2024-07-27,27,33,12,72
A01701,2024-10-30,30,29,10,69
A01702,2024-10-06,14,28,29,71
A01703,2024-02-04,32,20,23,75
A01704,2024-01-12,15,22,39,76
A01705,2024-07-13,32,35,13,80
A01706,2024-09-18,40,33,32,105
A01707,2024-04-05,39,16,16,71
A01708,2024-07-11,37,14,26,77
A01709,2024-11-15,22,34,12,68
A01710,2024-10-10,40,35,17,92
A01711,2024-02-21,38,22,20,80
A01712,2024-06-29,10,27,31,68
A01713,2024-06-29,28,34,35,97
A01714,2024-06-25,14,29,38,81
A01715,2024-09-07,20,13,17,50
A01716,2024-08-02,12,39,16,67
A01717,2024-11-18,22,18,16,56
A01718,2024-04-11,29,12,10,51
A01719,2024-01-29,16,35,39,90
A01720,2024-07-21,23,27,12,62
A01721,2024-03-14,12,20,18,50
A01722,2024-04-30,11,28,24,63
A01723,2024-11-22,32,22,40,94
A01724,2024-11-21,22,35,27,84
A01725,2024-03-14,36,17,10,63
A01726,2024-07-01,27,35,15,77
A01727,2024-04-30,20,30,11,61
A01728,2024-04-21,16,35,12,63
A01729,2024-06-25,29,23,38,90
A01730,2024-02-29,32,22,29,83
A01731,2024-11-21,17,20,20,57
A01732,2024-02-20,20,11,34,65
A01733,2024-03-19,12,16,24,52
A01734,2024-11-10,22,24,13,59
A01735,2024-09-23,20,38,32,90
A01736,2024-10-19,24,35,27,86
A01737,2024-05-07,22,14,23,59
A01738,2024-10-04,30,16,12,58
A01739,2024-03-20,11,34,25,70
A01740,2024-05-15,33,13,28,74
A01741,2024-05-20,39,18,39,96
A01742,2024-02-10,22,26,36,84
A01743,2024-03-13,16,35,22,73
A01744,2024-08-11,38,16,11,65
A01745,2024-07-07,33,32,31,96
A01746,2024-08-02,14,26,28,68
A01747,2024-07-12,21,39,31,91
A01748,2024-05-18,13,18,15,46
A01749,2024-10-25,38,15,34,87
A01750,2024-06-06,18,27,13,58
A01751,2024-01-31,11,13,24,48
A01752,2024-01-26,27,15,20,62
A01753,2024-03-21,15,37,31,83
A01754,2024-07-27,30,31,33,94
A01755,2024-07-07,25,18,19,62
A01756,2024-04-05,21,24,21,66
A01757,2024-01-05,18,37,40,95
A01758,2024-10-02,36,13,35,84
A01759,2024-12-01,32,25,31,88
A01760,2024-07-30,29,25,30,84
A01761,2024-03-24,40,16,39,95
A01762,2024-01-10,12,39,20,71
A01763,2024-06-17,37,29,18,84
A01764,2024-01-09,10,39,18,67
A01765,2024-02-26,24,10,35,69
A01766,2024-04-26,40,31,28,99
A01767,2024-12-04,21,31,10,62
A01768,2024-05-10,27,21,18,66
A01769,2024-08-07,26,21,21,68
A01770,2024-10-10,26,32,27,85
A01771,2024-09-15,30,35,12,77
A01772,2024-05-01,39,16,29,84
A01773,2024-04-18,20,18,19,57
A01774,2024-07-13,39,20,14,73
A01775,2024-11-29,35,11,16,62
A01776,2024-07-27,27,28,19,74
A01777,2024-08-06,38,10,28,76
A01778,2024-01-03,38,37,30,105
A01779,2024-03-30,19,34,12,65
A01780,2024-03-05,37,39,17,93
A01781,2024-09-21,30,16,14,60
A01782,2024-07-13,19,18,14,51
A01783,2024-07-28,17,14,23,54
A01784,2024-09-06,25,29,38,92
A01785,2024-08-19,39,13,11,63
A01786,2024-05-10,39,11,34,84
A01787,2024-02-07,25,10,11,46
A01788,2023-12-23,20,30,35,85
A01789,2024-05-02,26,14,23,63
A01790,2024-09-14,38,29,27,94
A01791,2024-03-14,19,18,25,62
A01792,2024-10-21,17,11,40,68
A01793,2024-03-29,12,16,16,44
A01794,2024-08-16,33,11,35,79
A01795,2024-05-23,15,27,20,62
A01796,2024-07-06,16,19,36,71
A01797,2024-09-27,36,20,19,75
A01798,2024-02-29,22,14,35,71
A01799,2024-05-25,33,17,19,69
A01800,2024-03-24,31,39,16,86
A01801,2024-02-23,25,17,40,82
A01802,2024-05-13,15,20,14,49
A01803,2024-01-27,34,21,12,67
A01804,2024-03-17,37,26,29,92
A01805,2024-08-08,34,17,36,87
A01806,2024-01-02,35,12,23,70
A01807,2024-09-29,37,23,11,71
A01808,2024-07-07,17,12,30,59
A01809,2024-03-27,34,23,29,86
A01810,2024-06-30,16,23,22,61
A01811,2024-09-25,35,17,10,62
A01812,2024-11-28,18,39,33,90
A01813,2024-06-19,31,25,33,89
A01814,2024-08-19,23,20,22,65
A01815,2024-10-08,25,30,22,77
A01816,2024-10-10,18,38,29,85
A01817,2024-08-24,40,10,36,86
A01818,2023-12-27,36,17,12,65
A01819,2024-03-30,29,19,19,67
A01820,2023-12-10,31,33,12,76
A01821,2024-02-19,32,18,16,66
A01822,2024-10-12,26,24,40,90
A01823,2024-09-09,34,29,35,98
A01824,2024-04-19,35,13,36,84
A01825,2024-01-30,38,14,11,63
A01826,2024-01-13,12,30,15,57
A01827,2024-11-03,21,38,21,80
A01828,2024-11-09,28,19,21,68
A01829,2024-07-06,30,30,33,93
A01830,2024-09-30,35,16,34,85
A01831,2024-09-30,37,11,24,72
A01832,2024-04-03,31,19,22,72
A01833,2024-08-12,23,23,34,80
A01834,2024-01-08,22,11,25,58
A01835,2024-07-30,39,29,19,87
A01836,2024-11-28,31,16,15,62
A01837,2024-09-27,22,19,39,80
A01838,2024-01-31,26,23,34,83
A01839,2024-09-23,17,21,17,55
A01840,2024-10-25,17,40,18,75
A01841,2024-05-19,18,29,15,62
A01842,2024-03-24,36,12,25,73
A01843,2024-07-31,24,37,27,88
A01844,2024-02-11,21,38,11,70
A01845,2024-01-18,25,32,11,68
A01846,2024-11-28,32,31,19,82
A01847,2024-04-18,22,40,31,93
A01848,2024-09-14,31,18,39,88
A01849,2024-03-24,29,25,31,85
A01850,2024-03-18,17,40,28,85
A01851,2024-10-22,34,17,39,90
A01852,2024-04-19,10,39,29,78
A01853,2024-08-13,24,36,12,72
A01854,2023-12-30,24,21,10,55
A01855,2024-06-04,10,17,37,64
A01856,2024-08-26,28,35,10,73
A01857,2024-01-17,27,26,25,78
A01858,2024-08-27,30,17,25,72
A01859,2024-05-24,39,20,38,97
A01860,2024-01-17,22,34,26,82
A01861,2024-01-20,27,40,23,90
A01862,2024-03-14,28,15,11,54
A01863,2024-09-22,17,37,14,68
A01864,2024-05-14,39,38,16,93
A01865,2024-10-14,16,40,32,88
A01866,2024-08-04,33,25,10,68
A01867,2024-05-11,30,13,17,60
A01868,2024-06-19,10,23,40,73
A01869,2024-04-29,15,27,19,61
A01870,2024-01-06,28,29,37,94
A01871,2024-01-04,23,36,21,80
A01872,2024-01-03,29,32,24,85
A01873,2024-07-03,36,27,32,95
A01874,2024-10-15,30,32,13,75
A01875,2024-10-07,18,14,16,48
A01876,2024-09-27,23,36,36,95
A01877,2024-09-20,27,15,10,52
A01878,2024-09-12,18,13,11,42
A01879,2024-01-10,39,34,17,90
A01880,2024-03-30,17,19,30,66
A01881,2024-05-09,19,18,24,61
A01882,2024-07-17,12,21,33,66
A01883,2024-10-06,26,35,34,95
A01884,2024-05-17,34,40,38,112
A01885,2024-03-10,11,40,31,82
A01886,2024-11-19,35,37,30,102
A01887,2024-10-29,25,35,35,95
A01888,2024-02-13,31,31,30,92
A01889,2024-11-15,28,28,10,66
A01890,2024-02-04,28,20,31,79
A01891,2024-09-02,37,17,30,84
A01892,2024-03-28,29,24,38,91
A01893,2024-01-03,16,38,11,65
A01894,2024-02-11,38,17,34,89
A01895,2024-01-17,10,24,17,51
A01896,2024-01-27,15,16,30,61
A01897,2024-11-16,23,19,37,79
A01898,2024-03-13,30,26,37,93
A01899,2024-06-26,25,11,23,59
A01900,2024-02-13,28,23,11,62
A01901,2024-11-30,34,26,21,81
A01902,2024-05-18,35,11,21,67
A01903,2024-12-07,12,19,35,66
A01904,2024-06-14,34,10,39,83
A01905,2024-03-25,18,27,39,84
A01906,2024-07-17,22,20,26,68
A01907,2024-09-23,32,19,28,79
A01908,2024-06-07,31,35,25,91
A01909,2024-07-31,27,22,40,89
A01910,2024-07-31,24,17,40,81
A01911,2024-01-15,27,30,16,73
A01912,2024-02-02,36,15,31,82
A01913,2024-07-18,29,13,10,52
A01914,2024-11-18,21,36,38,95
A01915,2024-07-02,24,14,32,70
A01916,2024-05-11,39,28,27,94
A01917,2024-04-04,12,28,20,60
A01918,2024-06-22,19,16,35,70
A01919,2024-06-29,19,34,11,64
A01920,2024-02-07,32,23,13,68
A01921,2024-06-20,11,33,18,62
A01922,2024-06-23,29,14,32,75
A01923,2024-02-09,11,34,17,62
A01924,2024-08-17,26,33,19,78
A01925,2024-04-05,40,38,33,111
A01926,2024-09-01,10,28,14,52
A01927,2024-05-21,11,31,30,72
A01928,2024-04-30,25,28,23,76
A01929,2024-01-20,22,24,39,85
A01930,2024-05-14,38,39,19,96
A01931,2024-10-13,28,37,24,89
A01932,2024-11-15,37,15,18,70
A01933,2024-01-21,20,31,16,67
A01934,2024-06-15,32,23,28,83
A01935,2024-11-16,40,12,23,75
A01936,2024-02-15,10,14,23,47
A01937,2024-02-16,36,28,30,94
A01938,2024-05-28,14,31,40,85
A01939,2023-12-22,24,38,37,99
A01940,2024-12-06,30,19,24,73
A01941,2024-01-21,37,21,25,83
A01942,2024-08-21,10,40,28,78
A01943,2024-01-09,13,37,19,69
A01944,2024-05-01,25,14,26,65
A01945,2024-11-14,38,20,24,82
A01946,2024-02-16,33,34,38,105
A01947,2024-07-13,27,30,39,96
A01948,2024-01-23,23,35,11,69
A01949,2024-10-20,25,32,12,69
A01950,2024-01-14,14,39,13,66
A01951,2024-02-05,35,19,36,90
A01952,2024-02-26,26,28,17,71
A01953,2024-04-21,16,33,28,77
A01954,2023-12-24,11,29,23,63
A01955,2024-06-27,23,35,35,93
A01956,2024-09-09,13,22,35,70
A01957,2024-10-14,30,28,30,88
A01958,2023-12-22,20,24,19,63
A01959,2024-08-26,38,29,14,81
A01960,2024-05-20,17,39,40,96
A01961,2024-12-06,10,12,36,58
A01962,2024-09-04,34,19,10,63
A01963,2024-01-02,28,33,25,86
A01964,2024-06-09,39,33,11,83
A01965,2024-08-29,30,34,12,76
A01966,2024-01-23,29,30,33,92
A01967,2024-08-14,36,33,10,79
A01968,2024-08-13,22,23,13,58
A01969,2024-03-08,26,37,30,93
A01970,2024-05-16,21,27,13,61
A01971,2024-06-29,23,38,18,79
A01972,2024-05-02,13,36,23,72
A01973,2024-02-16,37,18,16,71
A01974,2024-02-18,17,37,30,84
A01975,2024-07-06,23,31,21,75
A01976,2024-09-25,37,36,22,95
A01977,2024-05-21,40,27,33,100
A01978,2024-10-13,37,33,14,84
A01979,2024-05-25,27,29,29,85
A01980,2024-08-09,23,33,14,70
A01981,2024-03-06,39,25,20,84
A01982,2024-05-20,18,36,30,84
A01983,2024-04-17,33,29,37,99
A01984,2024-06-03,24,38,20,82
A01985,2024-02-25,34,24,23,81
A01986,2024-05-20,26,21,18,65
A01987,2024-10-04,32,16,34,82
A01988,2024-01-24,17,30,10,57
A01989,2024-10-07,35,33,17,85
A01990,2024-08-27,19,21,11,51
A01991,2024-06-10,30,19,36,85
A01992,2024-06-02,17,34,32,83
A01993,2023-12-12,29,19,33,81
A01994,2024-03-16,36,29,21,86
A01995,2024-02-22,19,16,13,48
A01996,2024-06-11,29,37,30,96
A01997,2024-08-28,13,33,28,74
A01998,2024-05-24,17,25,31,73
A01999,2024-10-20,11,31,25,67
A02000,2024-07-30,30,18,12,60
A02001,2024-01-05,39,22,24,85
A02002,2024-05-21,24,27,19,70
A02003,2024-11-21,28,33,12,73
A02004,2024-10-09,14,36,14,64
A02005,2024-06-26,13,12,29,54
A02006,2024-04-21,31,22,16,69
A02007,2024-03-27,39,11,22,72
A02008,2024-01-19,11,20,27,58
A02009,2024-02-02,17,16,18,51
A02010,2024-01-20,38,30,15,83
A02011,2024-04-26,23,19,36,78
A02012,2024-06-01,30,17,10,57
A02013,2024-03-18,24,26,22,72
A02014,2024-01-26,24,25,21,70
A02015,2024-06-17,22,31,29,82
A02016,2024-06-12,33,38,24,95
A02017,2024-11-16,29,14,34,77
A02018,2024-11-10,39,37,29,105
A02019,2024-03-27,35,29,21,85
A02020,2024-05-26,29,27,33,89
A02021,2024-08-04,25,39,15,79
A02022,2024-10-11,10,17,30,57
A02023,2024-10-04,31,27,17,75
A02024,2024-10-07,30,33,22,85
A02025,2024-11-28,25,15,28,68
A02026,2024-11-28,31,21,19,71
A02027,2024-07-22,36,25,21,82
A02028,2024-09-29,15,26,13,54
A02029,2024-05-19,23,38,25,86
A02030,2024-11-26,31,36,32,99
A02031,2024-11-04,20,31,29,80
A02032,2024-05-04,14,32,10,56
A02033,2024-02-20,28,20,33,81
A02034,2024-05-29,40,16,36,92
A02035,2024-05-04,30,19,33,82
A02036,2024-04-12,39,15,27,81
A02037,2024-02-20,40,15,20,75
A02038,2024-06-03,14,20,16,50
A02039,2024-04-08,10,29,11,50
A02040,2024-01-13,14,40,19,73
A02041,2024-03-18,40,24,32,96
A02042,2023-12-13,27,39,34,100
A02043,2024-10-15,19,29,31,79
A02044,2024-11-23,17,39,23,79
A02045,2024-03-26,16,13,26,55
A02046,2024-08-11,15,38,38,91
A02047,2024-02-11,18,14,32,64
A02048,2024-12-05,33,11,27,71
A02049,2024-01-08,33,31,21,85
A02050,2024-05-08,37,27,16,80
A02051,2024-02-19,32,16,19,67
A02052,2024-10-20,11,36,10,57
A02053,2024-10-31,11,13,39,63
A02054,2024-05-31,15,19,10,44
A02055,2024-06-04,15,13,16,44
A02056,2024-04-16,31,30,32,93
A02057,2024-03-28,21,23,24,68
A02058,2024-09-12,11,11,17,39
A02059,2024-08-23,14,20,31,65
A02060,2024-09-09,31,14,38,83
A02061,2024-12-08,35,25,16,76
A02062,2024-04-24,32,38,17,87
A02063,2023-12-12,10,36,19,65
A02064,2024-09-07,16,16,21,53
A02065,2024-04-07,29,35,11,75
A02066,2024-12-04,29,25,39,93
A02067,2024-01-30,32,19,12,63
A02068,2024-10-04,17,39,23,79
A02069,2024-03-28,12,14,37,63
A02070,2024-01-16,29,31,26,86
A02071,2024-05-26,37,22,37,96
A02072,2024-03-25,29,12,40,81
A02073,2024-06-02,23,30,23,76
A02074,2024-05-01,40,17,27,84
A02075,2024-07-08,20,24,12,56
A02076,2024-04-12,26,10,14,50
A02077,2024-09-02,19,11,40,70
A02078,2024-11-28,10,27,18,55
A02079,2024-09-12,22,31,30,83
A02080,2024-11-17,36,30,26,92
A02081,2024-09-23,21,26,16,63
A02082,2024-01-03,18,16,26,60
A02083,2024-11-24,40,33,23,96
A02084,2023-12-14,16,30,16,62
A02085,2024-02-11,39,20,18,77
A02086,2024-07-23,15,11,11,37
A02087,2024-05-29,22,10,20,52
A02088,2024-09-06,37,22,30,89
A02089,2024-10-07,11,19,27,57
A02090,2024-05-01,30,18,30,78
A02091,2024-02-04,36,21,23,80
A02092,2024-07-06,15,14,26,55
A02093,2023-12-31,39,36,10,85
A02094,2024-01-26,21,26,10,57
A02095,2024-01-25,35,33,13,81
A02096,2024-09-03,23,14,37,74
A02097,2024-11-30,24,35,38,97
A02098,2024-11-04,25,28,20,73
A02099,2024-05-20,20,19,23,62
A02100,2024-01-15,15,13,13,41
A02101,2024-04-01,20,28,21,69
A02102,2024-09-14,13,31,11,55
A02103,2024-03-29,25,40,12,77
A02104,2024-12-01,16,30,18,64
A02105,2024-10-21,15,21,23,59
A02106,2024-11-06,35,25,32,92
A02107,2024-09-07,29,33,22,84
A02108,2024-07-08,11,19,33,63
A02109,2024-06-23,33,11,13,57
A02110,2024-11-28,40,32,37,109
A02111,2024-06-24,32,20,31,83
A02112,2024-08-20,40,16,15,71
A02113,2024-06-30,24,12,20,56
A02114,2024-02-28,29,34,24,87
A02115,2024-05-31,14,22,33,69
A02116,2024-05-22,26,38,38,102
A02117,2024-09-09,24,34,19,77
A02118,2024-07-19,40,23,29,92
A02119,2024-05-25,22,26,25,73
A02120,2024-08-08,28,12,22,62
A02121,2024-10-05,40,26,17,83
A02122,2024-07-22,13,10,28,51
A02123,2024-11-02,25,14,34,73
A02124,2024-03-12,28,35,13,76
A02125,2024-03-23,34,33,12,79
A02126,2024-07-08,34,11,38,83
A02127,2024-05-12,39,31,31,101
A02128,2024-06-06,28,38,17,83
A02129,2024-10-05,19,13,13,45
A02130,2024-06-24,33,28,31,92
A02131,2024-11-11,19,25,14,58
A02132,2024-06-07,15,10,10,35
A02133,2024-09-08,33,36,18,87
A02134,2024-07-16,18,13,32,63
A02135,2024-02-27,20,20,39,79
A02136,2024-08-16,36,28,10,74
A02137,2024-07-16,18,30,14,62
A02138,2024-04-11,22,13,17,52
A02139,2024-01-10,13,30,22,65
A02140,2024-07-21,30,23,13,66
A02141,2024-10-14,19,12,11,42
A02142,2024-03-29,26,31,14,71
A02143,2024-07-06,32,14,22,68
A02144,2024-02-06,16,20,12,48
A02145,2024-03-03,17,16,20,53
A02146,2024-09-20,35,38,14,87
A02147,2024-07-22,28,37,14,79
A02148,2024-04-08,32,11,37,80
A02149,2024-09-19,39,20,22,81
A02150,2024-01-01,36,16,23,75
A02151,2024-07-07,27,10,15,52
A02152,2024-11-18,21,10,40,71
A02153,2024-04-12,39,33,11,83
A02154,2024-05-27,33,24,38,95
A02155,2024-07-20,34,31,16,81
A02156,2024-04-11,17,38,29,84
A02157,2024-04-19,22,22,39,83
A02158,2024-09-19,31,34,35,100
A02159,2024-09-14,26,40,28,94
A02160,2024-10-09,34,14,27,75
A02161,2024-11-25,17,24,35,76
A02162,2023-12-27,16,11,17,44
A02163,2024-10-28,35,11,27,73
A02164,2024-08-15,13,18,33,64
A02165,2024-04-16,23,16,14,53
A02166,2024-11-19,11,38,37,86
A02167,2024-08-07,16,20,29,65
A02168,2024-06-20,39,36,37,112
A02169,2024-10-31,22,11,19,52
A02170,2024-09-09,30,22,29,81
A02171,2024-03-27,18,27,18,63
A02172,2024-09-17,19,26,17,62
A02173,2024-04-02,12,27,36,75
A02174,2024-06-29,21,27,16,64
A02175,2024-08-14,17,12,37,66
A02176,2024-01-02,38,20,25,83
A02177,2024-02-06,40,36,40,116
A02178,2024-05-09,24,19,36,79
A02179,2024-07-28,25,25,40,90
A02180,2024-02-01,23,32,36,91
A02181,2024-07-19,14,31,13,58
A02182,2024-10-03,27,11,29,67
A02183,2023-12-14,29,15,10,54
A02184,2024-10-04,23,13,35,71
A02185,2024-06-05,25,30,25,80
A02186,2024-07-31,35,23,12,70
A02187,2024-12-01,33,24,37,94
A02188,2024-06-25,20,33,27,80
A02189,2024-09-30,36,29,31,96
A02190,2024-07-11,28,34,19,81
A02191,2024-10-29,15,40,34,89
A02192,2024-07-12,23,16,23,62
A02193,2024-04-22,13,39,21,73
A02194,2024-03-02,19,10,32,61
A02195,2023-12-27,17,30,34,81
A02196,2024-09-19,38,28,37,103
A02197,2024-08-14,29,24,26,79
A02198,2024-05-12,27,28,38,93
A02199,2024-03-10,10,37,30,77
A02200,2024-02-27,24,26,36,86
A02201,2024-08-18,30,39,13,82
A02202,2024-07-21,17,40,35,92
A02203,2024-02-06,23,27,11,61
A02204,2024-07-16,19,19,32,70
A02205,2024-04-05,29,26,35,90
A02206,2024-05-16,37,20,27,84
A02207,2024-11-09,10,17,17,44
A02208,2024-05-15,30,36,29,95
A02209,2024-07-02,28,32,24,84
A02210,2024-04-04,26,16,27,69
A02211,2024-12-05,10,31,33,74
A02212,2024-07-10,10,12,40,62
A02213,2024-06-22,19,19,32,70
A02214,2024-02-23,32,35,29,96
A02215,2024-03-26,23,27,40,90
A02216,2024-05-16,20,23,34,77
A02217,2024-09-23,18,35,22,75
A02218,2024-03-29,35,10,39,84
A02219,2024-06-24,14,14,34,62
A02220,2024-08-26,40,15,30,85
A02221,2024-11-16,11,30,29,70
A02222,2024-04-19,17,32,24,73
A02223,2024-06-07,29,26,17,72
A02224,2024-07-24,26,33,11,70
A02225,2024-04-21,38,27,18,83
A02226,2024-01-01,11,33,23,67
A02227,2024-02-03,14,13,35,62
A02228,2024-06-01,16,36,21,73
A02229,2024-08-15,30,40,31,101
A02230,2024-03-10,13,19,26,58
A02231,2024-07-10,32,16,19,67
A02232,2024-10-21,30,15,23,68
A02233,2024-10-25,36,19,27,82
A02234,2024-09-26,13,38,31,82
A02235,2024-05-23,38,35,26,99
A02236,2024-02-11,11,13,20,44
A02237,2024-10-28,16,13,22,51
A02238,2024-01-01,32,38,33,103
A02239,2024-01-22,16,12,31,59
A02240,2024-09-07,33,22,16,71
A02241,2024-05-01,21,17,19,57
A02242,2024-02-19,37,21,28,86
A02243,2024-11-16,26,23,28,77
A02244,2024-08-24,18,26,39,83
A02245,2024-08-18,19,18,15,52
A02246,2024-09-07,13,18,27,58
A02247,2024-04-23,28,25,15,68
A02248,2024-04-07,26,23,26,75
A02249,2024-03-22,31,21,12,64
A02250,2024-03-01,27,36,22,85
A02251,2024-04-19,16,13,19,48
A02252,2024-08-25,11,29,11,51
A02253,2024-01-02,16,39,19,74
A02254,2024-05-09,33,23,20,76
A02255,2024-05-19,15,25,17,57
A02256,2024-09-02,12,28,29,69
A02257,2024-01-28,14,34,16,64
A02258,2024-05-14,37,17,35,89
A02259,2024-10-04,12,12,10,34
A02260,2024-05-21,38,19,40,97
A02261,2024-07-12,24,35,40,99
A02262,2024-11-09,23,13,32,68
A02263,2023-12-25,37,26,25,88
A02264,2024-01-04,37,32,33,102
A02265,2024-11-29,37,31,18,86
A02266,2024-11-14,33,23,11,67
A02267,2023-12-11,24,40,30,94
A02268,2024-10-25,35,19,38,92
A02269,2024-10-28,23,38,17,78
A02270,2024-04-16,30,10,27,67
A02271,2024-06-22,37,30,27,94
A02272,2024-03-05,11,11,10,32
A02273,2024-06-19,28,33,29,90
A02274,2024-06-29,10,13,21,44
A02275,2024-04-06,40,13,18,71
A02276,2024-03-03,21,37,10,68
A02277,2024-01-12,36,36,30,102
A02278,2024-07-31,20,40,34,94
A02279,2024-04-19,36,21,17,74
A02280,2023-12-31,34,32,32,98
A02281,2024-11-07,25,25,30,80
A02282,2024-11-29,15,33,18,66
A02283,2024-06-11,14,40,38,92
A02284,2024-10-24,32,38,16,86
A02285,2024-05-28,36,34,33,103
A02286,2024-11-03,32,24,21,77
A02287,2024-06-14,13,36,36,85
A02288,2024-03-16,40,20,39,99
A02289,2024-01-31,34,33,40,107
A02290,2023-12-24,39,24,20,83
A02291,2024-05-10,11,10,35,56
A02292,2024-04-09,11,35,21,67
A02293,2024-03-18,29,26,22,77
A02294,2024-04-11,13,32,12,57
A02295,2024-07-27,32,37,17,86
A02296,2023-12-26,17,11,16,44
A02297,2024-10-13,31,24,15,70
A02298,2024-08-27,21,27,21,69
A02299,2024-09-12,21,36,30,87
A02300,2024-08-03,31,22,22,75
A02301,2024-07-30,18,31,18,67
A02302,2024-11-05,29,34,32,95
A02303,2024-12-04,27,30,19,76
A02304,2024-02-05,26,32,36,94
A02305,2024-02-08,25,40,33,98
A02306,2024-04-13,31,16,25,72
A02307,2024-08-09,29,17,22,68
A02308,2024-11-28,17,21,17,55
A02309,2024-02-29,27,10,25,62
A02310,2024-02-11,37,32,21,90
A02311,2024-01-10,17,34,39,90
A02312,2024-02-07,36,10,30,76
A02313,2024-04-04,37,29,20,86
A02314,2024-02-14,28,39,37,104
A02315,2024-01-30,17,28,39,84
A02316,2024-06-03,24,17,28,69
A02317,2024-04-14,13,29,15,57
A02318,2024-10-30,33,22,13,68
A02319,2024-07-27,35,12,38,85
A02320,2024-04-30,30,11,17,58
A02321,2024-05-01,31,24,19,74
A02322,2024-08-23,19,15,34,68
A02323,2024-07-29,29,24,22,75
A02324,2024-05-10,14,17,10,41
A02325,2024-03-28,27,11,29,67
A02326,2024-05-05,12,29,35,76
A02327,2024-09-22,21,28,23,72
A02328,2023-12-21,37,36,28,101
A02329,2024-04-08,21,15,40,76
A02330,2024-05-08,34,10,21,65
A02331,2024-09-23,25,17,13,55
A02332,2024-10-08,24,13,30,67
A02333,2024-09-13,14,17,30,61
A02334,2024-12-09,21,10,19,50
A02335,2023-12-14,28,16,10,54
A02336,2024-11-19,19,36,13,68
A02337,2023-12-12,11,15,23,49
A02338,2024-01-16,19,37,32,88
A02339,2024-03-06,22,40,14,76
A02340,2024-03-25,19,27,34,80
A02341,2024-01-28,17,20,18,55
A02342,2024-04-16,36,30,28,94
A02343,2024-08-18,19,10,22,51
A02344,2024-12-05,38,29,23,90
A02345,2024-06-08,19,22,16,57
A02346,2024-11-25,15,32,18,65
A02347,2024-02-05,36,10,16,62
A02348,2024-04-13,29,31,39,99
A02349,2024-03-18,21,11,22,54
A02350,2024-10-20,33,23,21,77
A02351,2024-07-15,27,27,15,69
A02352,2023-12-28,31,32,29,92
A02353,2024-09-07,18,18,32,68
A02354,2024-02-13,33,33,30,96
A02355,2024-04-29,11,14,40,65
A02356,2024-06-29,19,15,34,68
A02357,2024-10-25,26,22,36,84
A02358,2024-04-22,16,31,34,81
A02359,2023-12-15,27,26,12,65
A02360,2024-01-11,23,34,39,96
A02361,2024-04-13,24,38,29,91
A02362,2024-10-26,31,16,38,85
A02363,2024-10-10,34,18,26,78
A02364,2024-02-21,19,15,25,59
A02365,2024-08-15,22,35,22,79
A02366,2024-04-21,37,30,10,77
A02367,2024-02-14,23,17,40,80
A02368,2023-12-23,19,15,28,62
A02369,2024-07-05,17,31,39,87
A02370,2024-10-22,17,23,37,77
A02371,2024-06-27,12,27,31,70
A02372,2024-03-20,10,21,12,43
A02373,2024-04-25,40,35,35,110
A02374,2024-10-13,25,15,36,76
A02375,2024-05-11,14,40,20,74
A02376,2024-02-27,15,31,16,62
A02377,2024-03-02,30,21,40,91
A02378,2024-05-08,26,39,31,96
A02379,2024-03-02,32,37,25,94
A02380,2024-10-29,17,13,30,60
A02381,2024-07-11,28,17,32,77
A02382,2024-06-12,18,15,18,51
A02383,2023-12-11,35,16,24,75
A02384,2024-05-11,28,34,39,101
A02385,2024-04-07,36,15,14,65
A02386,2024-01-20,23,24,16,63
A02387,2024-06-20,31,26,36,93
A02388,2024-04-15,39,25,22,86
A02389,2024-02-11,20,22,35,77
A02390,2024-01-14,10,14,32,56
A02391,2024-10-09,39,15,25,79
A02392,2024-08-21,21,26,21,68
A02393,2024-07-23,23,15,15,53
A02394,2024-05-15,31,33,22,86
A02395,2023-12-21,36,30,37,103
A02396,2024-04-08,17,14,32,63
A02397,2024-11-17,31,13,14,58
A02398,2024-11-07,39,31,24,94
A02399,2024-02-10,18,21,19,58
A02400,2024-04-23,31,27,12,70
A02401,2024-06-23,17,34,17,68
A02402,2024-01-03,39,24,16,79
A02403,2024-10-22,27,11,25,63
A02404,2024-04-17,13,25,39,77
A02405,2024-04-17,31,18,25,74
A02406,2023-12-15,37,11,12,60
A02407,2024-07-10,13,32,40,85
A02408,2024-01-06,37,34,31,102
A02409,2024-02-20,33,15,30,78
A02410,2024-04-15,15,31,16,62
A02411,2024-10-11,17,13,21,51
A02412,2024-02-29,28,20,12,60
A02413,2024-03-22,22,39,40,101
A02414,2024-04-05,11,27,39,77
A02415,2024-10-05,36,29,20,85
A02416,2024-02-15,21,35,19,75
A02417,2024-01-29,15,20,30,65
A02418,2024-06-01,16,39,13,68
A02419,2024-04-10,19,18,19,56
A02420,2024-01-17,39,17,35,91
A02421,2023-12-17,19,39,22,80
A02422,2024-06-21,14,19,35,68
A02423,2024-03-28,36,30,23,89
A02424,2024-04-28,21,37,29,87
A02425,2024-07-14,10,37,31,78
A02426,2024-01-01,27,11,21,59
A02427,2024-01-16,36,34,34,104
A02428,2024-05-28,33,20,17,70
A02429,2024-07-23,35,25,22,82
A02430,2024-04-12,27,32,18,77
A02431,2024-06-14,32,24,21,77
A02432,2024-09-13,26,14,16,56
A02433,2024-12-06,21,37,37,95
A02434,2024-02-12,17,17,30,64
A02435,2024-02-08,20,40,16,76
A02436,2024-08-30,38,27,13,78
A02437,2024-10-28,16,16,17,49
A02438,2024-05-14,14,26,23,63
A02439,2024-10-19,19,24,10,53
A02440,2024-05-03,19,19,20,58
A02441,2024-08-29,15,33,12,60
A02442,2024-02-15,35,37,30,102
A02443,2024-09-03,15,10,30,55
A02444,2023-12-22,38,37,13,88
A02445,2024-10-10,11,11,10,32
A02446,2024-11-21,24,24,27,75
A02447,2024-11-18,16,11,31,58
A02448,2024-05-16,22,31,21,74
A02449,2024-01-07,28,16,32,76
A02450,2024-03-20,40,37,24,101
A02451,2024-11-28,36,17,19,72
A02452,2024-10-11,36,11,12,59
A02453,2024-06-29,10,30,24,64
A02454,2024-09-05,27,21,18,66
A02455,2024-05-23,23,24,27,74
A02456,2024-05-29,28,10,22,60
A02457,2024-08-30,21,14,37,72
A02458,2024-04-17,19,32,18,69
A02459,2024-11-19,40,34,19,93
A02460,2024-06-16,31,36,10,77
A02461,2024-01-12,12,20,37,69
A02462,2024-11-03,26,37,21,84
A02463,2024-08-24,23,28,18,69
A02464,2024-04-26,22,23,19,64
A02465,2024-01-12,23,23,17,63
A02466,2024-11-15,21,12,29,62
A02467,2024-11-08,19,22,13,54
A02468,2024-05-18,22,39,31,92
A02469,2024-06-19,17,10,21,48
A02470,2024-09-19,10,32,36,78
A02471,2024-07-30,13,30,17,60
A02472,2024-06-01,31,10,18,59
A02473,2024-06-04,39,12,39,90
A02474,2023-12-21,27,11,39,77
A02475,2023-12-22,37,13,11,61
A02476,2024-08-29,27,29,31,87
A02477,2024-11-06,39,30,31,100
A02478,2024-01-01,19,26,38,83
A02479,2024-11-05,17,10,36,63
A02480,2024-08-08,32,23,28,83
A02481,2024-05-17,22,26,21,69
A02482,2024-03-19,26,22,29,77
A02483,2024-03-20,29,31,18,78
A02484,2024-11-20,23,15,16,54
A02485,2023-12-10,11,26,23,60
A02486,2024-04-24,10,26,31,67
A02487,2024-11-15,23,24,14,61
A02488,2024-05-04,36,35,18,89
A02489,2024-12-03,11,23,21,55
A02490,2024-07-31,12,26,22,60
A02491,2024-05-20,11,40,35,86
A02492,2024-02-25,39,30,37,106
A02493,2023-12-17,30,14,22,66
A02494,2023-12-17,29,40,22,91
A02495,2024-07-25,17,10,25,52
A02496,2024-04-28,15,36,38,89
A02497,2024-09-02,23,31,16,70
A02498,2024-03-23,32,10,21,63
A02499,2024-06-08,38,26,14,78
A02500,2024-07-19,15,14,28,57
A02501,2024-02-25,13,37,22,72
A02502,2024-04-05,22,25,33,80
A02503,2024-02-08,24,13,30,67
A02504,2024-02-04,25,32,22,79
A02505,2024-01-12,16,13,27,56
A02506,2024-04-27,15,12,34,61
A02507,2024-04-01,18,38,12,68
A02508,2024-10-14,11,28,11,50
A02509,2024-02-13,10,34,35,79
A02510,2024-11-13,31,11,19,61
A02511,2024-11-19,13,35,33,81
A02512,2024-01-29,31,16,37,84
A02513,2024-11-09,26,24,26,76
A02514,2024-10-05,22,33,37,92
A02515,2024-04-07,30,23,37,90
A02516,2024-01-11,23,37,38,98
A02517,2024-08-04,35,20,17,72
A02518,2024-06-17,39,39,31,109
A02519,2024-06-23,15,36,30,81
A02520,2024-02-05,39,31,21,91
A02521,2024-10-12,32,22,19,73
A02522,2024-09-23,30,25,22,77
A02523,2024-09-30,27,18,24,69
A02524,2024-08-07,37,37,33,107
A02525,2024-12-05,16,39,35,90
A02526,2024-01-26,15,22,15,52
A02527,2024-03-07,15,28,33,76
A02528,2024-01-16,15,15,39,69
A02529,2024-10-05,20,40,21,81
A02530,2024-02-15,35,23,35,93
A02531,2024-08-19,38,25,22,85
A02532,2024-04-28,38,11,33,82
A02533,2024-05-02,38,37,17,92
A02534,2024-10-04,24,31,29,84
A02535,2024-10-06,33,31,37,101
A02536,2024-06-10,35,40,12,87
A02537,2024-01-25,29,10,32,71
A02538,2024-01-15,39,40,25,104
A02539,2024-05-02,14,39,38,91
A02540,2024-09-07,37,32,14,83
A02541,2024-11-26,11,14,27,52
A02542,2024-07-07,38,32,35,105
A02543,2024-11-21,21,33,30,84
A02544,2024-03-30,18,25,20,63
A02545,2024-02-26,32,13,14,59
A02546,2024-08-26,32,39,17,88
A02547,2024-05-20,14,26,10,50
A02548,2024-04-15,36,40,33,109
A02549,2024-08-16,23,23,37,83
A02550,2024-05-15,28,11,27,66
A02551,2024-10-17,18,12,29,59
A02552,2024-06-14,14,20,11,45
A02553,2024-09-16,31,25,12,68
A02554,2024-06-02,24,40,37,101
A02555,2024-09-09,31,17,40,88
A02556,2024-03-14,15,40,31,86
A02557,2024-11-28,24,29,30,83
A02558,2024-01-07,37,10,33,80
A02559,2024-06-17,28,16,16,60
A02560,2024-07-18,11,26,12,49
A02561,2023-12-15,25,32,40,97
A02562,2024-07-28,40,13,11,64
A02563,2024-12-09,16,21,31,68
A02564,2024-05-22,35,13,15,63
A02565,2024-02-06,14,21,17,52
A02566,2024-03-25,27,14,33,74
A02567,2024-08-12,38,38,36,112
A02568,2024-04-07,22,10,33,65
A02569,2024-03-23,33,38,23,94
A02570,2024-05-09,32,15,30,77
A02571,2024-11-05,17,39,35,91
A02572,2024-06-29,23,16,20,59
A02573,2024-05-31,13,30,18,61
A02574,2024-04-30,20,40,28,88
A02575,2024-10-27,30,13,28,71
A02576,2024-07-15,12,37,20,69
A02577,2024-08-12,11,37,22,70
A02578,2024-09-30,13,34,16,63
A02579,2024-05-12,24,19,22,65
A02580,2024-06-04,24,18,13,55
A02581,2024-03-30,26,39,32,97
A02582,2024-04-15,39,29,13,81
A02583,2024-07-28,19,34,29,82
A02584,2024-03-20,21,35,22,78
A02585,2024-01-21,24,11,29,64
A02586,2024-01-20,31,36,28,95
A02587,2023-12-27,37,26,17,80
A02588,2024-04-15,30,40,13,83
A02589,2024-07-23,28,35,17,80
A02590,2024-08-23,22,13,14,49
A02591,2024-03-11,11,26,16,53
A02592,2024-05-08,37,24,20,81
A02593,2024-01-22,36,38,37,111
A02594,2024-03-04,29,34,30,93
A02595,2024-02-24,29,11,24,64
A02596,2024-11-16,16,37,15,68
A02597,2024-05-31,33,28,21,82
A02598,2024-01-14,16,28,22,66
A02599,2024-09-28,20,38,16,74
A02600,2024-02-03,32,23,14,69
A02601,2024-06-21,26,20,32,78
A02602,2024-11-25,15,35,37,87
A02603,2024-11-07,12,39,27,78
A02604,2024-03-13,11,21,18,50
A02605,2024-01-17,28,24,23,75
A02606,2024-08-14,35,24,32,91
A02607,2024-02-10,15,15,12,42
A02608,2024-12-07,21,29,21,71
A02609,2024-07-11,27,16,34,77
A02610,2023-12-27,12,31,31,74
A02611,2024-11-22,33,34,27,94
A02612,2024-04-19,36,38,30,104
A02613,2024-05-08,13,37,40,90
A02614,2024-06-11,27,39,35,101
A02615,2024-11-30,38,23,30,91
A02616,2024-11-21,10,34,30,74
A02617,2024-03-19,21,34,33,88
A02618,2024-10-05,26,26,32,84
A02619,2024-05-11,15,21,24,60
A02620,2024-02-21,12,20,20,52
A02621,2024-11-13,16,11,32,59
A02622,2024-01-07,11,18,19,48
A02623,2024-04-19,23,33,33,89
A02624,2024-03-12,37,35,17,89
A02625,2024-03-06,22,25,37,84
A02626,2024-01-30,15,10,31,56
A02627,2023-12-19,20,37,24,81
A02628,2024-08-13,34,33,24,91
A02629,2024-07-28,21,10,31,62
A02630,2024-08-12,17,35,24,76
A02631,2024-01-26,20,16,40,76
A02632,2024-03-01,16,27,13,56
A02633,2024-09-22,30,17,21,68
A02634,2024-03-25,31,25,12,68
A02635,2024-07-28,12,36,32,80
A02636,2024-08-13,25,22,36,83
A02637,2024-09-21,11,22,28,61
A02638,2024-03-31,28,12,26,66
A02639,2024-02-12,29,40,32,101
A02640,2024-08-15,33,26,17,76
A02641,2024-11-03,30,35,34,99
A02642,2024-03-15,36,36,17,89
A02643,2024-11-25,24,27,28,79
A02644,2024-08-20,36,39,31,106
A02645,2024-06-16,38,39,21,98
A02646,2024-06-23,13,31,34,78
A02647,2024-04-04,39,19,29,87
A02648,2024-05-28,28,25,34,87
A02649,2024-09-01,27,16,34,77
A02650,2024-08-02,21,19,30,70
A02651,2024-07-29,27,15,25,67
A02652,2024-07-09,30,31,31,92
A02653,2024-02-28,17,39,23,79
A02654,2024-09-30,22,35,21,78
A02655,2024-05-29,38,11,13,62
A02656,2024-11-22,28,37,40,105
A02657,2024-11-05,36,17,15,68
A02658,2024-08-17,38,10,34,82
A02659,2024-08-03,13,22,27,62
A02660,2024-10-25,24,15,26,65
A02661,2024-05-25,39,16,30,85
A02662,2024-10-04,19,18,25,62
A02663,2023-12-26,31,25,32,88
A02664,2024-03-07,32,27,34,93
A02665,2024-04-14,29,23,19,71
A02666,2024-12-04,36,28,30,94
A02667,2023-12-22,13,21,15,49
A02668,2024-03-29,34,17,28,79
A02669,2024-08-04,24,40,29,93
A02670,2024-05-30,28,34,32,94
A02671,2024-02-16,24,14,33,71
A02672,2024-10-16,38,31,25,94
A02673,2024-10-19,30,19,23,72
A02674,2024-01-26,37,11,14,62
A02675,2024-07-14,24,15,29,68
A02676,2024-10-20,17,39,40,96
A02677,2024-10-24,38,11,37,86
A02678,2024-07-16,15,17,10,42
A02679,2024-07-04,16,17,15,48
A02680,2023-12-11,14,24,10,48
A02681,2024-11-06,23,17,40,80
A02682,2024-07-10,15,27,10,52
A02683,2024-11-01,15,35,11,61
A02684,2024-04-24,28,22,30,80
A02685,2024-12-07,29,20,22,71
A02686,2024-11-15,31,33,29,93
A02687,2024-06-03,36,20,21,77
A02688,2024-06-24,15,11,14,40
A02689,2024-07-09,26,14,19,59
A02690,2024-10-21,32,24,15,71
A02691,2024-08-27,26,21,33,80
A02692,2024-04-29,40,19,13,72
A02693,2023-12-30,12,12,27,51
A02694,2024-06-09,31,21,32,84
A02695,2024-05-24,29,29,34,92
A02696,2024-10-15,17,36,20,73
A02697,2024-10-31,13,32,29,74
A02698,2024-12-07,19,14,15,48
A02699,2024-07-10,26,28,19,73
A02700,2024-08-03,31,34,32,97
A02701,2024-11-07,24,24,16,64
A02702,2023-12-19,14,39,22,75
A02703,2024-10-18,23,18,15,56
A02704,2024-12-05,35,19,27,81
A02705,2024-06-16,15,22,22,59
A02706,2024-04-07,34,19,23,76
A02707,2024-08-05,21,19,40,80
A02708,2024-07-12,23,17,39,79
A02709,2024-08-22,28,26,15,69
A02710,2023-12-22,22,20,34,76
A02711,2024-10-08,28,26,37,91
A02712,2024-11-13,34,18,35,87
A02713,2024-10-05,31,30,21,82
A02714,2024-11-18,27,25,38,90
A02715,2024-07-11,38,17,37,92
A02716,2024-01-31,26,29,35,90
A02717,2024-04-23,34,12,27,73
A02718,2024-06-29,22,14,17,53
A02719,2024-03-02,15,16,38,69
A02720,2024-05-22,14,16,36,66
A02721,2024-03-05,34,29,11,74
A02722,2024-07-31,18,28,19,65
A02723,2023-12-17,16,30,30,76
A02724,2024-07-26,30,34,37,101
A02725,2024-03-26,16,17,27,60
A02726,2024-09-22,24,15,30,69
A02727,2024-08-17,17,37,33,87
A02728,2024-10-13,25,38,20,83
A02729,2024-06-15,33,35,32,100
A02730,2024-03-18,15,10,15,40
A02731,2024-07-06,27,19,15,61
A02732,2024-04-18,24,13,32,69
A02733,2024-09-08,12,29,30,71
A02734,2024-05-14,12,28,40,80
A02735,2024-09-23,36,22,40,98
A02736,2024-04-12,22,21,40,83
A02737,2024-07-22,38,39,24,101
A02738,2024-05-12,36,19,12,67
A02739,2024-06-27,18,16,22,56
A02740,2024-04-09,23,25,14,62
A02741,2024-11-13,27,29,36,92
A02742,2024-10-01,30,26,28,84
A02743,2024-01-05,40,19,26,85
A02744,2024-03-05,16,37,10,63
A02745,2024-11-15,12,33,37,82
A02746,2023-12-27,34,19,21,74
A02747,2024-05-01,30,21,15,66
A02748,2024-06-03,13,31,36,80
A02749,2024-02-27,30,38,33,101
A02750,2024-09-28,19,20,39,78
A02751,2024-04-17,23,12,15,50
A02752,2024-03-13,30,27,30,87
A02753,2024-09-09,29,33,21,83
A02754,2024-08-22,32,29,35,96
A02755,2024-12-07,10,15,19,44
A02756,2024-05-10,18,16,39,73
A02757,2023-12-13,30,37,16,83
A02758,2024-01-20,38,10,40,88
A02759,2024-05-19,11,14,38,63
A02760,2024-01-31,36,25,35,96
A02761,2024-08-06,36,26,14,76
A02762,2024-02-04,39,17,30,86
A02763,2024-02-08,31,28,12,71
A02764,2024-10-10,25,23,37,85
A02765,2024-07-01,21,16,13,50
A02766,2024-05-04,32,14,25,71
A02767,2024-11-13,25,28,15,68
A02768,2024-10-25,13,23,15,51
A02769,2024-02-23,11,13,36,60
A02770,2024-04-07,19,14,13,46
A02771,2024-05-27,16,32,31,79
A02772,2024-07-23,18,21,35,74
A02773,2024-09-27,22,26,26,74
A02774,2024-05-03,10,38,32,80
A02775,2024-07-12,18,21,10,49
A02776,2024-09-17,35,11,19,65
A02777,2024-09-12,22,21,20,63
A02778,2024-11-02,16,33,20,69
A02779,2024-06-24,12,40,23,75
A02780,2024-08-18,14,22,40,76
A02781,2024-02-10,29,34,23,86
A02782,2024-09-13,18,36,31,85
A02783,2024-08-05,23,27,18,68
A02784,2023-12-20,35,31,10,76
A02785,2024-11-04,13,18,18,49
A02786,2024-09-22,21,12,32,65
A02787,2023-12-16,35,38,20,93
A02788,2024-09-22,40,15,31,86
A02789,2024-01-20,21,34,21,76
A02790,2024-08-12,11,20,14,45
A02791,2024-01-08,22,32,14,68
A02792,2024-11-24,38,39,19,96
A02793,2024-07-05,15,18,37,70
A02794,2024-08-31,29,27,31,87
A02795,2024-04-18,23,40,10,73
A02796,2024-05-31,25,18,37,80
A02797,2024-04-12,16,35,26,77
A02798,2024-06-08,18,14,36,68
A02799,2024-11-12,16,38,32,86
A02800,2024-01-28,36,40,38,114
A02801,2024-05-31,36,30,14,80
A02802,2024-02-08,26,37,40,103
A02803,2024-03-18,26,27,12,65
A02804,2024-08-20,31,12,15,58
A02805,2024-02-05,34,19,12,65
A02806,2024-11-08,12,40,33,85
A02807,2024-03-19,40,17,17,74
A02808,2024-01-15,12,24,23,59
A02809,2024-08-22,31,16,31,78
A02810,2024-12-09,34,40,23,97
A02811,2024-02-04,34,15,40,89
A02812,2024-04-22,23,14,13,50
A02813,2024-02-12,30,12,21,63
A02814,2023-12-18,23,37,16,76
A02815,2024-06-27,37,18,12,67
A02816,2023-12-20,32,30,37,99
A02817,2024-11-28,16,34,10,60
A02818,2024-03-15,21,12,17,50
A02819,2024-04-20,15,21,35,71
A02820,2024-08-10,24,21,24,69
A02821,2024-03-24,40,13,25,78
A02822,2024-11-15,25,32,17,74
A02823,2024-12-05,32,12,12,56
A02824,2024-03-07,40,15,26,81
A02825,2024-05-07,29,21,20,70
A02826,2024-11-14,19,21,14,54
A02827,2024-04-19,31,19,36,86
A02828,2024-10-12,21,10,36,67
A02829,2024-04-16,24,14,25,63
A02830,2024-06-02,14,29,25,68
A02831,2024-03-15,10,25,10,45
A02832,2024-12-09,37,24,25,86
A02833,2024-05-13,12,14,11,37
A02834,2024-07-15,16,33,32,81
A02835,2024-08-13,12,14,20,46
A02836,2024-09-26,18,13,25,56
A02837,2024-11-08,12,23,18,53
A02838,2024-10-28,28,33,28,89
A02839,2024-02-19,23,36,35,94
A02840,2024-01-24,38,34,22,94
A02841,2024-07-16,15,35,19,69
A02842,2024-07-10,32,36,12,80
A02843,2023-12-20,14,36,36,86
A02844,2024-03-22,36,38,16,90
A02845,2024-09-19,26,37,17,80
A02846,2024-04-26,22,26,36,84
A02847,2024-04-27,35,33,14,82
A02848,2024-09-15,36,24,35,95
A02849,2024-11-22,17,10,28,55
A02850,2024-02-29,21,15,22,58
A02851,2024-07-08,14,36,36,86
A02852,2024-01-08,32,10,36,78
A02853,2024-12-05,33,31,39,103
A02854,2024-10-21,26,35,10,71
A02855,2024-03-17,19,32,23,74
A02856,2024-10-11,31,22,38,91
A02857,2024-08-26,20,16,38,74
A02858,2024-01-14,11,26,11,48
A02859,2024-10-12,36,31,26,93
A02860,2024-12-06,16,30,32,78
A02861,2024-07-25,39,30,13,82
A02862,2024-08-31,40,16,16,72
A02863,2024-09-23,20,34,40,94
A02864,2024-08-20,32,10,22,64
A02865,2024-07-03,10,40,25,75
A02866,2024-08-16,12,23,26,61
A02867,2024-09-16,18,28,18,64
A02868,2024-05-30,19,29,34,82
A02869,2024-10-31,33,10,33,76
A02870,2024-04-07,13,34,27,74
A02871,2024-11-03,12,38,14,64
A02872,2024-06-26,15,26,11,52
A02873,2024-06-28,16,32,27,75
A02874,2024-05-02,13,36,32,81
A02875,2024-10-23,22,26,36,84
A02876,2024-02-24,25,17,31,73
A02877,2024-04-25,29,37,28,94
A02878,2024-04-14,27,36,26,89
A02879,2024-07-31,22,23,10,55
A02880,2024-03-04,30,23,15,68
A02881,2024-03-15,29,26,18,73
A02882,2024-05-15,39,21,28,88
A02883,2024-10-29,36,34,27,97
A02884,2024-01-03,20,13,12,45
A02885,2024-06-28,18,32,32,82
A02886,2024-03-27,19,20,37,76
A02887,2024-05-19,23,26,23,72
A02888,2024-07-24,34,40,36,110
A02889,2023-12-26,14,33,37,84
A02890,2024-01-30,36,13,32,81
A02891,2023-12-28,12,31,31,74
A02892,2024-03-19,22,32,27,81
A02893,2024-01-15,19,20,21,60
A02894,2024-10-31,32,40,40,112
A02895,2024-11-02,19,13,13,45
A02896,2024-11-01,17,28,17,62
A02897,2024-02-17,34,27,17,78
A02898,2024-06-05,23,26,19,68
A02899,2024-04-17,11,16,32,59
A02900,2023-12-10,23,34,36,93
A02901,2024-10-12,18,22,36,76
A02902,2024-04-12,35,19,23,77
A02903,2024-10-04,35,10,19,64
A02904,2024-09-07,13,32,12,57
A02905,2024-07-14,30,15,25,70
A02906,2024-12-02,22,23,33,78
A02907,2024-11-16,13,30,13,56
A02908,2024-10-09,14,40,35,89
A02909,2024-02-16,25,15,17,57
A02910,2024-07-30,34,28,22,84
A02911,2023-12-22,22,15,28,65
A02912,2024-11-08,13,34,27,74
A02913,2024-04-20,34,24,12,70
A02914,2024-06-30,19,17,24,60
A02915,2024-06-11,29,21,13,63
A02916,2024-03-30,18,32,27,77
A02917,2024-06-28,22,34,21,77
A02918,2024-05-03,17,35,24,76
A02919,2024-11-14,39,10,31,80
A02920,2024-09-10,30,33,10,73
A02921,2024-10-15,15,32,23,70
A02922,2024-08-06,25,26,10,61
A02923,2023-12-22,20,14,23,57
A02924,2024-11-11,35,32,36,103
A02925,2023-12-18,19,29,23,71
A02926,2024-03-05,18,21,22,61
A02927,2024-04-02,21,24,40,85
A02928,2024-01-10,35,40,15,90
A02929,2023-12-22,35,20,12,67
A02930,2024-09-13,32,26,30,88
A02931,2024-10-07,23,16,11,50
A02932,2024-03-17,20,11,11,42
A02933,2024-08-19,10,17,33,60
A02934,2024-05-19,10,27,36,73
A02935,2024-06-09,22,27,32,81
A02936,2024-04-04,37,10,27,74
A02937,2024-08-31,28,33,26,87
A02938,2024-08-03,22,27,22,71
A02939,2024-10-01,14,11,28,53
A02940,2024-02-03,21,13,14,48
A02941,2024-01-15,25,11,34,70
A02942,2024-11-11,31,29,17,77
A02943,2024-04-24,28,40,36,104
A02944,2024-03-10,33,19,17,69
A02945,2024-08-26,14,21,30,65
A02946,2024-05-23,35,13,38,86
A02947,2024-08-06,15,32,25,72
A02948,2024-04-16,27,16,37,80
A02949,2024-07-17,35,32,18,85
A02950,2024-05-14,32,35,39,106
A02951,2024-10-18,10,18,35,63
A02952,2024-09-08,17,19,32,68
A02953,2024-04-15,15,36,23,74
A02954,2024-08-04,35,36,36,107
A02955,2024-08-30,22,37,10,69
A02956,2024-11-02,18,10,35,63
A02957,2024-08-02,24,36,38,98
A02958,2024-07-20,25,23,34,82
A02959,2024-01-29,14,19,31,64
A02960,2024-10-26,17,18,12,47
A02961,2024-07-16,31,34,25,90
A02962,2024-08-08,34,26,12,72
A02963,2024-11-07,27,34,16,77
A02964,2024-05-19,14,10,40,64
A02965,2023-12-26,32,26,22,80
A02966,2024-03-14,15,20,30,65
A02967,2023-12-28,22,21,33,76
A02968,2024-09-26,25,11,27,63
A02969,2024-01-17,26,32,20,78
A02970,2024-09-16,19,15,35,69
A02971,2024-11-10,23,33,12,68
A02972,2024-01-28,27,22,29,78
A02973,2024-09-25,21,13,33,67
A02974,2024-06-26,29,17,30,76
A02975,2024-11-08,17,27,19,63
A02976,2024-05-22,17,30,32,79
A02977,2024-08-10,10,18,17,45
A02978,2024-08-26,31,18,14,63
A02979,2024-03-22,31,18,30,79
A02980,2024-09-22,33,39,19,91
A02981,2024-01-03,14,37,12,63
A02982,2024-04-25,26,17,30,73
A02983,2024-02-10,37,14,31,82
A02984,2024-01-15,27,34,11,72
A02985,2024-06-04,33,23,16,72
A02986,2024-08-23,22,29,20,71
A02987,2024-01-11,26,34,37,97
A02988,2024-11-09,15,33,11,59
A02989,2024-09-04,37,18,27,82
A02990,2024-10-09,36,20,26,82
A02991,2023-12-26,32,16,32,80
A02992,2024-11-22,35,39,33,107
A02993,2024-01-18,22,28,37,87
A02994,2024-01-27,22,25,14,61
A02995,2024-04-12,19,23,15,57
A02996,2024-07-29,40,14,16,70
A02997,2023-12-14,17,12,19,48
A02998,2024-09-27,38,30,17,85
A02999,2024-02-23,31,12,11,54
A03000,2024-09-25,31,38,39,108
A03001,2024-01-08,37,14,11,62
A03002,2024-09-14,10,32,21,63
A03003,2024-07-07,39,13,17,69
A03004,2024-04-30,17,38,39,94
A03005,2024-05-04,38,26,34,98
A03006,2023-12-30,12,11,34,57
A03007,2024-10-14,34,33,15,82
A03008,2024-08-17,17,33,20,70
A03009,2024-04-24,28,23,23,74
A03010,2024-03-07,36,23,20,79
A03011,2024-07-01,10,12,39,61
A03012,2024-01-26,37,36,40,113
A03013,2024-08-20,22,35,30,87
A03014,2023-12-25,23,33,26,82
A03015,2024-11-05,13,20,23,56
A03016,2024-06-18,39,33,17,89
A03017,2024-03-07,28,33,25,86
A03018,2024-12-07,15,20,10,45
A03019,2024-11-14,21,38,27,86
A03020,2024-07-24,16,14,35,65
A03021,2024-08-03,35,18,37,90
A03022,2024-03-26,24,15,30,69
A03023,2024-12-09,17,29,21,67
A03024,2024-09-15,18,23,11,52
A03025,2024-02-23,23,21,15,59
A03026,2024-09-19,27,25,15,67
A03027,2024-05-25,34,24,34,92
A03028,2024-04-06,31,17,25,73
A03029,2024-11-21,17,10,10,37
A03030,2024-01-26,18,34,26,78
A03031,2024-02-18,34,12,37,83
A03032,2024-12-07,29,17,21,67
A03033,2024-11-12,16,39,34,89
A03034,2024-01-17,17,25,38,80
A03035,2024-05-25,40,19,25,84
A03036,2024-03-30,33,17,19,69
A03037,2024-05-30,33,16,38,87
A03038,2024-08-28,17,21,24,62
A03039,2024-02-11,37,17,33,87
A03040,2024-03-30,20,31,27,78
A03041,2024-03-30,29,10,37,76
A03042,2024-05-28,34,22,21,77
A03043,2024-05-19,33,37,35,105
A03044,2024-12-06,35,37,40,112
A03045,2023-12-27,37,23,19,79
A03046,2024-08-26,31,19,22,72
A03047,2024-08-24,20,12,20,52
A03048,2024-07-29,20,26,28,74
A03049,2024-04-04,21,19,18,58
A03050,2024-01-02,19,20,18,57
A03051,2024-03-23,19,12,34,65
A03052,2024-01-15,11,19,33,63
A03053,2024-07-29,21,25,37,83
A03054,2024-09-06,28,14,30,72
A03055,2024-03-11,13,39,26,78
A03056,2024-04-22,20,23,10,53
A03057,2024-11-05,23,20,14,57
A03058,2024-01-26,24,38,31,93
A03059,2024-04-06,21,29,37,87
A03060,2024-06-27,26,19,27,72
A03061,2024-04-17,11,24,35,70
A03062,2024-11-10,18,17,31,66
A03063,2024-11-15,39,20,22,81
A03064,2024-05-19,30,23,23,76
A03065,2024-06-28,32,29,14,75
A03066,2024-01-27,29,33,28,90
A03067,2024-10-12,12,39,34,85
A03068,2024-08-28,29,14,34,77
A03069,2024-08-18,28,18,23,69
A03070,2024-10-03,32,39,18,89
A03071,2024-06-03,12,35,19,66
A03072,2024-10-10,17,33,17,67
A03073,2024-01-27,22,25,29,76
A03074,2024-01-28,20,12,40,72
A03075,2024-08-01,21,12,30,63
A03076,2024-09-08,28,15,30,73
A03077,2024-11-17,30,15,37,82
A03078,2024-01-24,19,28,36,83
A03079,2024-07-11,16,31,28,75
A03080,2024-09-08,36,27,30,93
A03081,2024-06-08,32,23,34,89
A03082,2024-07-28,14,31,14,59
A03083,2024-07-30,30,10,40,80
A03084,2024-09-29,38,15,18,71
A03085,2024-10-20,20,33,30,83
A03086,2024-11-15,40,21,16,77
A03087,2024-04-22,19,30,21,70
A03088,2024-02-10,12,19,35,66
A03089,2023-12-16,17,23,10,50
A03090,2024-12-03,28,25,22,75
A03091,2024-11-29,39,15,40,94
A03092,2024-03-14,35,18,31,84
A03093,2024-11-03,18,30,31,79
A03094,2024-08-14,20,28,14,62
A03095,2024-08-27,11,13,22,46
A03096,2024-06-11,33,40,24,97
A03097,2024-11-17,23,38,25,86
A03098,2023-12-15,15,11,22,48
A03099,2024-02-12,17,39,17,73
A03100,2024-06-30,31,23,17,71
A03101,2024-03-20,12,11,17,40
A03102,2024-01-13,15,14,17,46
A03103,2024-07-25,16,19,15,50
A03104,2024-06-22,35,18,27,80
A03105,2024-11-26,22,26,33,81
A03106,2024-07-04,29,39,39,107
A03107,2024-07-26,15,33,31,79
A03108,2024-08-22,22,28,23,73
A03109,2024-10-22,28,23,14,65
A03110,2024-10-08,18,22,36,76
A03111,2024-07-26,37,20,16,73
A03112,2024-01-07,20,33,19,72
A03113,2024-08-19,26,40,21,87
A03114,2024-04-10,22,10,20,52
A03115,2023-12-17,40,38,27,105
A03116,2024-04-29,39,13,16,68
A03117,2024-06-27,27,16,13,56
A03118,2024-07-18,26,40,40,106
A03119,2024-11-18,37,36,11,84
A03120,2023-12-15,39,29,15,83
A03121,2024-10-05,17,23,35,75
A03122,2024-03-07,29,37,17,83
A03123,2024-10-27,40,22,30,92
A03124,2024-04-22,13,25,35,73
A03125,2024-11-13,37,40,39,116
A03126,2024-06-26,24,18,13,55
A03127,2024-09-02,12,28,16,56
A03128,2024-05-20,30,14,14,58
A03129,2024-01-24,39,34,34,107
A03130,2024-07-16,10,15,23,48
A03131,2024-06-12,18,17,40,75
A03132,2024-03-07,37,37,23,97
A03133,2023-12-20,11,40,40,91
A03134,2024-12-06,35,26,33,94
A03135,2024-05-27,16,17,29,62
A03136,2024-02-28,35,33,34,102
A03137,2024-08-12,34,29,30,93
A03138,2024-07-20,32,35,11,78
A03139,2024-02-18,14,17,11,42
A03140,2024-02-11,28,29,32,89
A03141,2024-05-05,26,27,21,74
A03142,2024-04-22,36,25,33,94
A03143,2024-11-17,30,32,20,82
A03144,2024-05-19,23,15,15,53
A03145,2024-04-25,21,26,22,69
A03146,2024-03-13,25,21,17,63
A03147,2024-02-16,38,31,14,83
A03148,2024-09-30,36,23,36,95
A03149,2024-07-26,38,36,20,94
A03150,2024-11-27,27,37,33,97
A03151,2024-05-25,15,28,14,57
A03152,2024-09-10,24,38,31,93
A03153,2023-12-23,28,36,28,92
A03154,2024-09-23,20,15,32,67
A03155,2024-11-22,39,38,34,111
A03156,2024-01-12,30,11,40,81
A03157,2024-11-08,20,13,40,73
A03158,2024-10-04,37,34,29,100
A03159,2023-12-22,33,12,22,67
A03160,2024-06-06,12,21,37,70
A03161,2024-06-18,35,13,33,81
A03162,2024-06-06,40,10,30,80
A03163,2024-07-19,18,31,20,69
A03164,2024-04-15,36,12,35,83
A03165,2024-01-24,34,38,20,92
A03166,2024-08-06,29,39,16,84
A03167,2023-12-14,17,29,26,72
A03168,2024-02-15,40,11,38,89
A03169,2024-06-14,15,40,27,82
A03170,2024-02-06,13,33,11,57
A03171,2024-02-19,17,19,15,51
A03172,2024-06-29,29,29,24,82
A03173,2024-04-10,16,30,11,57
A03174,2024-01-13,32,35,29,96
A03175,2024-07-23,14,19,30,63
A03176,2024-11-18,39,14,20,73
A03177,2024-05-12,39,39,34,112
A03178,2024-06-12,28,30,36,94
A03179,2024-02-15,34,11,39,84
A03180,2024-08-18,33,21,17,71
A03181,2024-01-03,37,14,24,75
A03182,2024-10-24,30,17,40,87
A03183,2024-08-20,38,21,24,83
A03184,2024-11-08,22,33,25,80
A03185,2024-05-05,35,37,26,98
A03186,2024-10-08,25,11,20,56
A03187,2024-01-01,28,12,14,54
A03188,2024-12-02,13,39,26,78
A03189,2024-02-10,17,19,14,50
A03190,2024-08-19,19,23,14,56
A03191,2024-08-27,36,27,23,86
A03192,2024-03-03,26,29,20,75
A03193,2024-03-11,15,32,36,83
A03194,2024-04-16,25,33,16,74
A03195,2024-09-10,12,40,11,63
A03196,2024-04-28,19,23,34,76
A03197,2024-01-17,23,15,23,61
A03198,2024-09-02,19,32,24,75
A03199,2023-12-28,11,40,24,75
A03200,2024-10-09,36,16,10,62
A03201,2024-07-24,25,15,29,69
A03202,2024-04-14,38,40,35,113
A03203,2024-11-14,37,28,21,86
A03204,2024-01-31,40,25,11,76
A03205,2024-03-24,24,12,26,62
A03206,2024-05-07,24,28,23,75
A03207,2024-09-07,28,12,32,72
A03208,2023-12-14,18,14,25,57
A03209,2024-11-03,15,29,35,79
A03210,2024-01-02,29,18,31,78
A03211,2024-07-22,26,19,29,74
A03212,2024-01-07,16,32,16,64
A03213,2024-04-16,20,11,12,43
A03214,2023-12-15,40,30,40,110
A03215,2024-01-26,36,31,18,85
A03216,2024-04-25,39,31,30,100
A03217,2024-03-01,38,36,12,86
A03218,2024-05-10,38,23,14,75
A03219,2024-11-04,19,12,25,56
A03220,2024-02-08,37,20,14,71
A03221,2024-12-04,38,13,15,66
A03222,2023-12-14,21,23,35,79
A03223,2024-08-16,11,33,16,60
A03224,2024-11-27,29,30,19,78
A03225,2024-03-17,12,29,10,51
A03226,2024-05-26,34,29,27,90
A03227,2024-05-19,16,14,38,68
A03228,2024-05-05,34,15,19,68
A03229,2024-10-05,21,13,27,61
A03230,2024-01-15,15,33,37,85
A03231,2024-04-22,35,25,30,90
A03232,2024-10-16,31,11,10,52
A03233,2024-09-30,33,33,36,102
A03234,2024-11-11,27,22,10,59
A03235,2024-01-20,38,35,33,106
A03236,2024-02-14,39,17,32,88
A03237,2024-06-27,28,16,26,70
A03238,2024-09-01,23,17,29,69
A03239,2024-07-20,15,35,12,62
A03240,2024-06-06,19,22,24,65
A03241,2024-02-08,17,13,29,59
A03242,2024-04-08,40,15,34,89
A03243,2024-09-09,10,20,30,60
A03244,2024-11-28,39,18,30,87
A03245,2024-05-18,32,12,19,63
A03246,2024-10-28,38,16,29,83
A03247,2024-02-03,36,17,37,90
A03248,2024-06-28,37,39,33,109
A03249,2024-04-05,39,36,16,91
A03250,2024-10-30,28,16,34,78
A03251,2024-01-23,21,27,17,65
A03252,2023-12-18,17,18,40,75
A03253,2024-05-25,32,38,33,103
A03254,2024-04-01,12,16,30,58
A03255,2024-03-17,21,13,18,52
A03256,2024-02-28,26,14,15,55
A03257,2024-02-27,30,14,14,58
A03258,2024-08-13,21,26,25,72
A03259,2024-02-26,35,11,25,71
A03260,2024-05-27,20,10,24,54
A03261,2024-02-24,23,26,10,59
A03262,2024-08-07,37,30,23,90
A03263,2024-02-17,35,24,14,73
A03264,2024-03-20,24,36,27,87
A03265,2024-02-17,25,13,23,61
A03266,2024-04-06,16,39,24,79
A03267,2024-04-30,15,28,23,66
A03268,2024-11-13,40,14,16,70
A03269,2024-04-12,27,17,39,83
A03270,2024-01-16,26,16,24,66
A03271,2024-01-03,14,24,36,74
A03272,2024-03-27,21,33,21,75
A03273,2024-07-18,33,24,22,79
A03274,2023-12-23,19,31,13,63
A03275,2024-11-05,29,15,23,67
A03276,2024-09-04,39,33,39,111
A03277,2024-11-03,28,11,36,75
A03278,2024-01-01,13,35,21,69
A03279,2024-06-30,28,10,15,53
A03280,2024-05-16,21,25,28,74
A03281,2024-09-17,28,25,29,82
A03282,2024-04-14,36,37,14,87
A03283,2024-09-01,22,37,21,80
A03284,2024-11-20,34,17,24,75
A03285,2024-06-20,13,27,13,53
A03286,2024-01-08,26,10,37,73
A03287,2024-05-26,28,21,38,87
A03288,2024-11-19,18,16,22,56
A03289,2024-09-28,30,37,19,86
A03290,2024-01-31,37,21,18,76
A03291,2024-09-29,25,33,19,77
A03292,2024-04-21,25,10,24,59
A03293,2024-04-14,18,16,35,69
A03294,2024-02-13,30,25,36,91
A03295,2024-07-15,13,36,15,64
A03296,2024-07-23,32,32,17,81
A03297,2024-06-14,34,24,40,98
A03298,2024-10-01,11,40,10,61
A03299,2024-06-23,23,12,35,70
A03300,2024-02-08,30,13,17,60
A03301,2024-10-26,38,31,26,95
A03302,2024-09-09,13,29,10,52
A03303,2024-11-18,35,13,27,75
A03304,2024-03-31,39,29,13,81
A03305,2024-01-03,11,36,20,67
A03306,2024-02-16,31,25,17,73
A03307,2024-02-06,36,33,32,101
A03308,2023-12-21,28,16,34,78
A03309,2024-09-12,26,25,39,90
A03310,2024-01-10,21,39,27,87
A03311,2023-12-16,28,29,28,85
A03312,2024-05-22,22,14,27,63
A03313,2024-01-24,18,25,32,75
A03314,2024-11-22,25,18,29,72
A03315,2024-02-13,33,17,39,89
A03316,2024-06-15,31,31,35,97
A03317,2024-07-19,25,18,19,62
A03318,2024-03-25,22,26,16,64
A03319,2024-08-22,10,14,12,36
A03320,2024-05-21,31,40,17,88
A03321,2024-06-12,31,28,11,70
A03322,2024-09-18,29,30,39,98
A03323,2024-05-14,19,37,35,91
A03324,2024-01-08,17,10,34,61
A03325,2024-05-12,28,26,37,91
A03326,2024-01-17,12,34,18,64
A03327,2024-03-20,14,39,17,70
A03328,2023-12-23,31,36,37,104
A03329,2024-10-15,31,23,31,85
A03330,2024-09-05,18,29,24,71
A03331,2024-10-31,22,34,34,90
A03332,2024-03-16,15,32,27,74
A03333,2024-11-03,34,24,20,78
A03334,2024-11-11,10,12,34,56
A03335,2024-06-07,40,18,24,82
A03336,2024-06-15,18,31,25,74
A03337,2024-02-07,29,37,28,94
A03338,2024-03-02,38,35,40,113
A03339,2024-11-21,32,23,13,68
A03340,2024-04-04,25,40,24,89
A03341,2024-08-02,29,12,34,75
A03342,2024-10-13,26,36,39,101
A03343,2024-05-05,16,35,30,81
A03344,2023-12-30,27,39,19,85
A03345,2024-07-19,20,13,14,47
A03346,2024-10-04,14,13,19,46
A03347,2024-06-30,26,36,22,84
A03348,2024-03-01,20,34,31,85
A03349,2024-05-19,12,20,24,56
A03350,2024-12-08,20,31,17,68
A03351,2024-10-23,17,23,30,70
A03352,2024-06-05,11,18,18,47
A03353,2024-10-23,29,32,30,91
A03354,2024-05-10,12,23,21,56
A03355,2024-04-04,10,26,20,56
A03356,2023-12-10,37,33,28,98
A03357,2024-12-04,25,25,20,70
A03358,2024-05-06,22,37,24,83
A03359,2024-11-25,25,20,26,71
A03360,2024-05-21,13,23,40,76
A03361,2024-07-20,27,27,18,72
A03362,2024-09-10,36,25,19,80
A03363,2024-11-17,22,17,20,59
A03364,2024-09-25,29,34,38,101
A03365,2024-12-04,29,19,16,64
A03366,2024-03-01,21,28,23,72
A03367,2024-01-17,12,23,33,68
A03368,2024-05-09,33,40,29,102
A03369,2024-05-16,36,24,29,89
A03370,2024-01-03,40,13,30,83
A03371,2024-08-08,10,29,29,68
A03372,2024-10-10,36,22,20,78
A03373,2024-04-16,39,40,19,98
A03374,2024-10-29,12,23,28,63
A03375,2024-08-29,38,24,22,84
A03376,2024-04-12,15,27,10,52
A03377,2024-04-11,18,21,27,66
A03378,2024-12-05,36,13,38,87
A03379,2024-09-20,10,29,39,78
A03380,2024-02-03,39,25,17,81
A03381,2024-04-27,11,31,10,52
A03382,2024-01-19,37,18,38,93
A03383,2024-09-03,19,13,38,70
A03384,2024-02-03,37,11,39,87
A03385,2024-12-08,40,13,20,73
A03386,2024-10-03,14,17,33,64
A03387,2024-06-26,29,16,33,78
A03388,2024-08-02,11,14,15,40
A03389,2024-04-03,34,27,17,78
A03390,2024-11-29,38,12,38,88
A03391,2024-10-11,21,31,38,90
A03392,2024-11-29,32,39,15,86
A03393,2024-07-31,14,37,40,91
A03394,2024-03-23,32,28,10,70
A03395,2024-03-01,23,18,16,57
A03396,2023-12-23,15,18,36,69
A03397,2024-07-05,19,39,14,72
A03398,2024-09-14,21,31,40,92
A03399,2024-07-25,10,30,24,64
A03400,2024-09-11,17,40,40,97
A03401,2024-02-26,22,10,11,43
A03402,2024-09-01,27,13,26,66
A03403,2024-08-12,18,18,18,54
A03404,2024-05-24,21,38,17,76
A03405,2024-01-24,36,19,31,86
A03406,2024-02-13,26,23,19,68
A03407,2024-11-12,20,25,38,83
A03408,2024-01-15,30,17,25,72
A03409,2024-02-18,22,26,36,84
A03410,2024-02-07,11,32,30,73
A03411,2024-06-02,19,21,30,70
A03412,2024-11-24,10,39,34,83
A03413,2024-09-08,12,26,39,77
A03414,2024-04-05,11,29,28,68
A03415,2024-07-08,27,25,17,69
A03416,2024-08-27,25,26,28,79
A03417,2024-08-12,29,34,27,90
A03418,2024-09-07,21,24,32,77
A03419,2023-12-11,24,25,13,62
A03420,2023-12-31,14,16,31,61
A03421,2024-11-29,29,18,18,65
A03422,2024-09-30,12,27,10,49
A03423,2024-06-05,34,16,40,90
A03424,2024-10-03,24,18,10,52
A03425,2024-10-12,40,30,16,86
A03426,2024-04-29,12,36,40,88
A03427,2024-04-23,24,12,11,47
A03428,2024-09-23,36,27,29,92
A03429,2024-06-04,30,34,34,98
A03430,2024-11-02,37,27,14,78
A03431,2024-08-20,12,18,16,46
A03432,2024-09-20,29,15,31,75
A03433,2024-11-10,26,24,39,89
A03434,2024-11-29,20,39,10,69
A03435,2024-11-06,11,10,36,57
A03436,2024-03-19,28,40,31,99
A03437,2024-09-27,10,25,40,75
A03438,2024-02-08,32,35,30,97
A03439,2024-10-28,31,24,23,78
A03440,2024-01-09,31,21,13,65
A03441,2024-01-02,14,19,10,43
A03442,2024-06-20,34,38,23,95
A03443,2024-08-08,10,19,39,68
A03444,2024-01-13,33,35,36,104
A03445,2024-02-19,27,29,37,93
A03446,2024-08-31,30,23,36,89
A03447,2024-08-24,25,10,25,60
A03448,2024-02-09,30,26,10,66
A03449,2024-09-03,25,16,40,81
A03450,2024-10-18,35,28,11,74
A03451,2024-09-21,15,34,32,81
A03452,2024-03-12,15,40,36,91
A03453,2024-08-13,11,38,28,77
A03454,2024-03-15,17,38,38,93
A03455,2024-11-22,18,32,22,72
A03456,2024-06-02,33,20,20,73
A03457,2024-08-09,31,28,24,83
A03458,2024-04-26,11,29,10,50
A03459,2024-07-21,40,28,13,81
A03460,2023-12-15,34,28,34,96
A03461,2024-04-16,29,24,10,63
A03462,2024-05-29,32,29,31,92
A03463,2024-02-25,20,11,13,44
A03464,2024-10-17,35,30,14,79
A03465,2024-08-03,38,28,17,83
A03466,2024-03-28,18,33,13,64
A03467,2024-08-31,26,21,24,71
A03468,2024-06-06,11,19,38,68
A03469,2024-10-27,36,10,40,86
A03470,2024-01-05,24,34,31,89
A03471,2024-10-13,35,22,26,83
A03472,2024-05-25,28,23,11,62
A03473,2024-07-02,10,27,21,58
A03474,2024-04-18,37,38,34,109
A03475,2024-09-30,32,25,20,77
A03476,2024-03-20,32,17,35,84
A03477,2024-02-17,40,26,29,95
A03478,2024-01-08,29,24,37,90
A03479,2024-11-16,12,37,18,67
A03480,2024-09-24,24,24,39,87
A03481,2023-12-29,36,25,17,78
A03482,2024-08-19,34,25,16,75
A03483,2024-04-11,18,15,13,46
A03484,2024-09-21,29,23,40,92
A03485,2023-12-19,17,36,17,70
A03486,2024-12-07,13,30,18,61
A03487,2024-08-21,39,35,21,95
A03488,2024-05-11,40,10,28,78
A03489,2024-02-28,27,29,26,82
A03490,2024-01-20,31,36,34,101
A03491,2024-05-30,32,35,40,107
A03492,2024-08-21,12,25,36,73
A03493,2023-12-24,24,33,30,87
A03494,2024-08-31,19,30,10,59
A03495,2024-04-20,12,30,26,68
A03496,2024-07-18,35,32,27,94
A03497,2024-10-08,15,19,32,66
A03498,2024-09-29,10,27,31,68
A03499,2024-04-22,21,10,24,55
A03500,2024-10-24,21,30,33,84
A03501,2024-04-19,39,20,29,88
A03502,2024-06-16,13,17,22,52
A03503,2024-03-15,29,29,29,87
A03504,2024-06-06,10,20,13,43
A03505,2024-05-09,24,22,35,81
A03506,2024-10-05,16,18,16,50
A03507,2024-01-01,31,16,37,84
A03508,2024-01-27,22,29,19,70
A03509,2024-02-21,38,22,24,84
A03510,2024-09-29,17,19,39,75
A03511,2024-04-07,11,26,31,68
A03512,2023-12-15,18,27,31,76
A03513,2024-08-27,30,37,36,103
A03514,2024-09-29,27,22,30,79
A03515,2024-09-06,16,27,34,77
A03516,2024-04-27,12,15,10,37
A03517,2024-05-09,10,31,14,55
A03518,2024-05-31,19,15,22,56
A03519,2024-11-20,18,32,38,88
A03520,2024-06-28,22,36,37,95
A03521,2024-10-23,35,28,13,76
A03522,2024-02-04,28,40,36,104
A03523,2024-04-27,23,29,20,72
A03524,2024-01-24,20,26,22,68
A03525,2024-06-14,30,17,33,80
A03526,2024-04-27,22,23,14,59
A03527,2024-07-07,10,30,13,53
A03528,2023-12-25,15,37,26,78
A03529,2024-11-20,19,36,20,75
A03530,2024-10-27,10,10,15,35
A03531,2024-10-07,19,18,30,67
A03532,2024-08-20,26,39,33,98
A03533,2024-03-07,39,11,26,76
A03534,2024-02-08,37,28,29,94
A03535,2024-11-20,20,23,31,74
A03536,2024-10-11,14,22,15,51
A03537,2024-05-10,13,13,19,45
A03538,2024-11-25,35,27,33,95
A03539,2024-04-05,21,39,15,75
A03540,2024-04-27,16,33,36,85
A03541,2023-12-26,21,32,34,87
A03542,2024-02-02,33,39,29,101
A03543,2023-12-19,13,28,10,51
A03544,2024-10-20,23,12,33,68
A03545,2024-01-16,38,14,17,69
A03546,2024-01-31,18,11,22,51
A03547,2024-08-11,19,15,24,58
A03548,2024-07-09,20,22,39,81
A03549,2024-10-28,24,32,21,77
A03550,2024-10-03,17,30,27,74
A03551,2024-04-26,27,28,23,78
A03552,2024-01-27,11,23,32,66
A03553,2024-05-29,11,33,22,66
A03554,2024-06-15,26,22,18,66
A03555,2024-02-03,14,13,31,58
A03556,2024-06-03,24,12,29,65
A03557,2023-12-21,13,28,22,63
A03558,2024-05-07,10,19,10,39
A03559,2024-11-01,23,19,21,63
A03560,2024-08-06,17,17,23,57
A03561,2024-10-06,36,14,11,61
A03562,2024-09-18,23,14,27,64
A03563,2024-03-14,39,25,23,87
A03564,2024-08-19,18,30,26,74
A03565,2024-09-07,23,13,40,76
A03566,2024-03-19,37,10,11,58
A03567,2024-01-06,21,40,21,82
A03568,2024-08-17,28,15,26,69
A03569,2024-04-03,11,37,34,82
A03570,2024-09-20,10,34,18,62
A03571,2024-05-20,15,32,13,60
A03572,2024-11-05,35,30,29,94
A03573,2024-04-24,20,18,37,75
A03574,2024-05-30,27,24,32,83
A03575,2024-05-05,25,18,33,76
A03576,2024-10-02,39,24,36,99
A03577,2024-08-09,30,30,23,83
A03578,2024-07-03,18,19,19,56
A03579,2024-08-31,23,15,11,49
A03580,2024-06-13,36,40,40,116
A03581,2024-09-13,19,12,27,58
A03582,2024-07-03,21,31,24,76
A03583,2023-12-30,39,35,13,87
A03584,2024-11-05,23,26,11,60
A03585,2024-11-16,27,36,37,100
A03586,2024-01-31,37,39,35,111
A03587,2024-11-21,21,37,32,90
A03588,2024-04-05,18,13,32,63
A03589,2024-08-16,16,39,18,73
A03590,2024-09-03,30,13,36,79
A03591,2024-04-25,29,29,33,91
A03592,2024-04-27,27,32,16,75
A03593,2024-10-15,33,28,38,99
A03594,2024-05-18,37,30,13,80
A03595,2024-09-26,34,21,37,92
A03596,2024-09-18,29,27,20,76
A03597,2024-10-04,24,27,15,66
A03598,2024-02-18,24,15,16,55
A03599,2024-06-11,29,12,36,77
A03600,2024-10-07,26,15,16,57
A03601,2024-10-09,15,13,33,61
A03602,2024-09-23,10,13,27,50
A03603,2024-09-15,26,13,23,62
A03604,2024-05-29,27,28,11,66
A03605,2024-10-05,30,26,15,71
A03606,2024-07-01,12,12,22,46
A03607,2024-03-12,14,16,30,60
A03608,2024-11-20,32,35,40,107
A03609,2024-03-16,34,34,35,103
A03610,2024-06-25,29,17,33,79
A03611,2024-10-30,23,13,27,63
A03612,2024-11-08,35,39,17,91
A03613,2024-09-09,27,17,33,77
A03614,2024-08-23,14,19,24,57
A03615,2024-06-25,11,20,23,54
A03616,2024-10-21,36,31,23,90
A03617,2024-02-03,14,23,17,54
A03618,2024-09-10,31,30,15,76
A03619,2024-05-29,37,36,32,105
A03620,2024-01-04,32,36,36,104
A03621,2024-10-04,32,24,16,72
A03622,2024-11-16,32,34,27,93
A03623,2024-02-06,16,29,39,84
A03624,2024-03-21,14,39,20,73
A03625,2024-07-27,31,40,21,92
A03626,2024-08-30,23,18,38,79
A03627,2024-06-20,28,20,10,58
A03628,2024-01-25,17,19,14,50
A03629,2024-11-03,33,18,38,89
A03630,2024-09-29,11,12,37,60
A03631,2024-09-23,40,39,21,100
A03632,2024-12-01,22,13,27,62
A03633,2024-11-11,14,36,25,75
A03634,2024-03-14,16,15,27,58
A03635,2024-11-22,16,25,33,74
A03636,2024-03-10,40,24,29,93
A03637,2024-09-23,10,38,33,81
A03638,2024-09-19,12,12,40,64
A03639,2024-01-16,12,19,25,56
A03640,2024-09-11,20,18,35,73
A03641,2024-07-09,39,21,29,89
A03642,2024-07-05,34,36,10,80
A03643,2024-01-17,26,40,18,84
A03644,2024-11-21,11,20,34,65
A03645,2024-10-22,25,39,10,74
A03646,2023-12-11,19,20,24,63
A03647,2024-03-24,10,17,21,48
A03648,2024-07-23,10,11,38,59
A03649,2024-02-06,11,32,25,68
A03650,2024-02-02,12,11,33,56
A03651,2024-11-01,10,30,36,76
A03652,2023-12-14,12,22,38,72
A03653,2024-05-04,38,10,25,73
A03654,2024-05-20,20,13,16,49
A03655,2024-01-10,31,12,11,54
A03656,2023-12-30,28,30,17,75
A03657,2024-09-10,13,29,12,54
A03658,2024-04-26,30,16,18,64
A03659,2024-08-26,29,25,31,85
A03660,2024-08-20,15,21,31,67
A03661,2023-12-26,23,36,38,97
A03662,2023-12-16,35,35,30,100
A03663,2024-04-23,23,20,15,58
A03664,2024-04-09,13,35,35,83
A03665,2024-11-15,20,37,37,94
A03666,2024-10-23,20,11,11,42
A03667,2024-06-02,13,35,22,70
A03668,2024-05-13,15,20,17,52
A03669,2024-04-16,30,35,25,90
A03670,2024-10-29,35,14,29,78
A03671,2024-06-05,12,30,40,82
A03672,2024-05-10,18,19,27,64
A03673,2024-01-22,18,26,22,66
A03674,2024-02-13,14,14,25,53
A03675,2024-01-04,32,38,11,81
A03676,2024-02-17,38,21,23,82
A03677,2024-07-05,32,38,17,87
A03678,2023-12-16,38,34,21,93
A03679,2024-11-04,11,12,24,47
A03680,2024-03-16,18,33,19,70
A03681,2024-02-11,28,31,16,75
A03682,2024-08-26,34,21,36,91
A03683,2024-02-14,37,22,40,99
A03684,2024-02-01,28,13,21,62
A03685,2024-05-09,29,34,11,74
A03686,2024-04-26,17,20,17,54
A03687,2024-08-16,26,15,22,63
A03688,2024-03-03,24,11,32,67
A03689,2024-10-16,26,13,36,75
A03690,2024-10-11,15,35,18,68
A03691,2023-12-28,36,10,35,81
A03692,2024-09-03,13,13,25,51
A03693,2024-08-22,20,26,38,84
A03694,2024-03-03,10,23,24,57
A03695,2024-10-09,26,36,13,75
A03696,2024-01-30,18,20,28,66
A03697,2024-01-06,13,12,28,53
A03698,2024-08-16,31,31,24,86
A03699,2024-11-04,13,35,37,85
A03700,2024-08-30,16,23,28,67
A03701,2024-06-11,27,35,26,88
A03702,2024-09-12,37,29,16,82
A03703,2024-03-30,36,20,38,94
A03704,2024-08-12,24,13,27,64
A03705,2024-04-26,29,27,27,83
A03706,2024-02-08,39,12,16,67
A03707,2024-01-15,21,10,35,66
A03708,2024-07-20,23,28,36,87
A03709,2024-03-10,26,38,27,91
A03710,2024-05-18,21,26,18,65
A03711,2024-10-21,16,40,25,81
A03712,2024-05-08,29,15,17,61
A03713,2024-01-04,27,35,34,96
A03714,2024-08-10,35,28,35,98
A03715,2024-06-18,19,12,10,41
A03716,2024-10-20,27,13,26,66
A03717,2024-08-20,20,19,10,49
A03718,2024-02-04,30,26,34,90
A03719,2024-11-07,16,20,18,54
A03720,2024-03-01,10,32,23,65
A03721,2024-01-07,36,25,13,74
A03722,2024-06-21,17,12,29,58
A03723,2024-05-17,36,40,39,115
A03724,2024-08-13,28,38,13,79
A03725,2024-11-01,21,31,40,92
A03726,2024-06-30,24,36,31,91
A03727,2024-05-27,23,37,24,84
A03728,2024-06-03,14,11,30,55
A03729,2024-04-20,27,17,10,54
A03730,2024-05-22,22,25,36,83
A03731,2024-11-06,36,35,25,96
A03732,2024-07-03,26,10,15,51
A03733,2024-04-06,37,21,31,89
A03734,2024-03-19,33,10,33,76
A03735,2024-11-05,30,11,13,54
A03736,2024-06-15,38,27,37,102
A03737,2024-05-19,18,11,20,49
A03738,2024-10-16,12,36,37,85
A03739,2024-09-20,31,33,15,79
A03740,2024-12-04,17,20,34,71
A03741,2023-12-20,15,10,34,59
A03742,2024-05-15,27,17,31,75
A03743,2024-05-21,29,36,19,84
A03744,2024-05-05,11,26,31,68
A03745,2024-06-08,10,25,36,71
A03746,2024-05-12,39,37,22,98
A03747,2023-12-30,18,24,13,55
A03748,2024-07-18,27,35,19,81
A03749,2024-07-10,22,25,15,62
A03750,2024-08-22,38,26,26,90
A03751,2024-01-06,39,39,15,93
A03752,2024-01-29,21,29,31,81
A03753,2024-09-12,20,38,19,77
A03754,2024-04-19,17,24,28,69
A03755,2024-03-07,16,25,30,71
A03756,2024-11-11,18,21,13,52
A03757,2024-07-01,11,24,24,59
A03758,2023-12-25,29,36,24,89
A03759,2024-01-11,28,40,16,84
A03760,2024-10-09,17,34,32,83
A03761,2024-07-17,34,39,38,111
A03762,2024-08-20,36,19,33,88
A03763,2024-02-27,29,34,37,100
A03764,2024-08-14,39,10,26,75
A03765,2024-07-04,35,16,12,63
A03766,2024-03-14,14,17,20,51
A03767,2024-06-05,32,21,29,82
A03768,2023-12-24,16,27,22,65
A03769,2024-05-13,38,20,30,88
A03770,2024-09-04,39,28,14,81
A03771,2024-09-21,31,38,37,106
A03772,2024-01-04,32,30,38,100
A03773,2024-03-25,36,19,25,80
A03774,2024-07-15,28,27,23,78
A03775,2024-04-30,22,13,22,57
A03776,2024-11-23,25,33,21,79
A03777,2024-10-21,10,23,10,43
A03778,2024-09-05,25,35,35,95
A03779,2024-09-16,29,15,27,71
A03780,2024-08-19,38,18,13,69
A03781,2024-03-08,16,29,34,79
A03782,2024-06-26,35,32,23,90
A03783,2024-04-06,13,28,40,81
A03784,2024-11-11,40,10,15,65
A03785,2023-12-30,13,37,19,69
A03786,2024-01-26,17,24,11,52
A03787,2024-05-10,17,17,21,55
A03788,2024-09-26,14,18,27,59
A03789,2024-03-15,37,22,25,84
A03790,2024-02-25,25,34,22,81
A03791,2024-03-25,18,18,27,63
A03792,2024-08-15,31,30,28,89
A03793,2024-12-03,11,25,13,49
A03794,2024-04-15,11,14,35,60
A03795,2024-01-01,16,25,28,69
A03796,2024-03-29,33,17,17,67
A03797,2024-02-08,18,38,29,85
A03798,2024-07-27,29,11,40,80
A03799,2024-02-17,32,38,17,87
A03800,2024-02-12,17,22,17,56
A03801,2024-11-17,33,35,39,107
A03802,2023-12-21,35,33,22,90
A03803,2024-06-07,26,13,25,64
A03804,2023-12-16,40,20,27,87
A03805,2024-03-16,37,40,16,93
A03806,2024-03-19,10,36,34,80
A03807,2024-02-28,35,33,40,108
A03808,2024-02-22,20,30,17,67
A03809,2024-02-16,22,15,39,76
A03810,2024-06-15,31,17,30,78
A03811,2024-06-11,14,32,30,76
A03812,2024-11-22,11,22,12,45
A03813,2024-08-24,13,12,30,55
A03814,2024-05-17,10,30,14,54
A03815,2024-05-13,15,10,26,51
A03816,2024-12-09,20,37,24,81
A03817,2024-03-13,39,35,17,91
A03818,2024-09-07,36,20,19,75
A03819,2024-10-14,20,18,37,75
A03820,2024-07-30,40,21,30,91
A03821,2024-07-30,25,31,37,93
A03822,2024-04-05,26,22,33,81
A03823,2024-06-01,40,40,29,109
A03824,2024-08-24,39,11,32,82
A03825,2024-06-05,35,22,16,73
A03826,2024-06-25,30,24,33,87
A03827,2024-06-29,38,14,31,83
A03828,2024-06-25,23,24,31,78
A03829,2024-11-20,36,24,13,73
A03830,2023-12-25,25,29,17,71
A03831,2024-08-08,18,28,31,77
A03832,2024-01-01,27,37,32,96
A03833,2023-12-24,31,13,38,82
A03834,2024-06-10,38,10,37,85
A03835,2024-08-20,14,34,35,83
A03836,2024-11-21,35,14,38,87
A03837,2024-09-30,16,36,39,91
A03838,2024-05-12,18,23,22,63
A03839,2024-10-07,37,40,13,90
A03840,2024-11-26,11,22,15,48
A03841,2024-01-10,33,27,29,89
A03842,2024-04-04,22,20,32,74
A03843,2024-09-09,36,35,12,83
A03844,2024-03-23,22,38,20,80
A03845,2024-08-30,38,32,20,90
A03846,2024-02-22,36,28,36,100
A03847,2024-09-12,25,14,27,66
A03848,2024-05-08,29,33,21,83
A03849,2024-10-23,21,16,20,57
A03850,2024-04-15,25,18,20,63
A03851,2024-08-09,35,20,17,72
A03852,2024-09-11,15,14,28,57
A03853,2024-12-02,24,38,19,81
A03854,2024-07-29,24,36,13,73
A03855,2024-10-14,30,22,30,82
A03856,2024-06-13,22,30,19,71
A03857,2024-03-27,35,27,12,74
A03858,2024-11-28,34,30,34,98
A03859,2024-09-12,28,14,30,72
A03860,2024-07-06,29,26,15,70
A03861,2024-11-14,37,30,37,104
A03862,2024-04-04,17,26,21,64
A03863,2024-03-06,25,39,36,100
A03864,2024-11-18,13,17,38,68
A03865,2024-08-11,24,21,34,79
A03866,2024-04-26,14,37,33,84
A03867,2024-11-12,22,10,11,43
A03868,2024-10-27,17,13,13,43
A03869,2024-04-21,27,24,17,68
A03870,2024-09-08,33,19,35,87
A03871,2024-01-19,40,33,10,83
A03872,2024-07-21,26,25,23,74
A03873,2024-07-21,34,29,34,97
A03874,2024-06-30,23,25,10,58
A03875,2024-05-10,31,20,33,84
A03876,2024-11-15,10,25,20,55
A03877,2024-11-27,27,29,16,72
A03878,2024-02-05,13,33,34,80
A03879,2024-10-31,31,27,25,83
A03880,2024-09-19,26,18,16,60
A03881,2024-04-04,26,10,39,75
A03882,2024-06-14,14,28,36,78
A03883,2024-06-23,21,15,10,46
A03884,2024-03-31,27,14,21,62
A03885,2024-06-26,37,19,23,79
A03886,2024-07-17,16,13,27,56
A03887,2024-05-04,39,36,38,113
A03888,2024-06-12,35,25,27,87
A03889,2024-12-08,39,29,23,91
A03890,2024-11-24,17,39,18,74
A03891,2023-12-24,11,20,14,45
A03892,2024-03-08,31,35,14,80
A03893,2024-07-25,11,24,23,58
A03894,2024-05-11,23,16,24,63
A03895,2024-01-19,19,34,20,73
A03896,2024-05-26,37,12,26,75
A03897,2024-06-12,29,40,10,79
A03898,2024-11-23,34,38,34,106
A03899,2024-03-07,11,32,15,58
A03900,2024-11-14,29,40,23,92
A03901,2024-05-14,11,22,20,53
A03902,2024-09-10,23,35,27,85
A03903,2024-10-25,37,10,40,87
A03904,2024-04-11,28,40,24,92
A03905,2024-08-24,10,40,33,83
A03906,2024-02-07,28,34,32,94
A03907,2024-05-13,34,34,28,96
A03908,2024-02-09,36,23,34,93
A03909,2024-08-02,12,11,39,62
A03910,2023-12-21,10,25,28,63
A03911,2024-04-22,32,14,27,73
A03912,2024-11-01,25,18,10,53
A03913,2024-12-03,24,11,22,57
A03914,2024-04-15,16,18,13,47
A03915,2024-09-24,20,31,17,68
A03916,2024-09-30,15,40,29,84
A03917,2024-09-07,27,33,37,97
A03918,2024-07-12,33,35,13,81
A03919,2024-05-26,15,19,10,44
A03920,2024-02-18,26,25,10,61
A03921,2024-02-19,22,22,30,74
A03922,2024-05-08,17,28,10,55
A03923,2024-06-02,40,10,10,60
A03924,2024-02-09,17,22,10,49
A03925,2024-11-27,34,39,16,89
A03926,2024-02-29,20,11,27,58
A03927,2024-05-25,17,18,20,55
A03928,2024-11-11,22,31,38,91
A03929,2024-02-19,24,11,20,55
A03930,2024-08-27,38,11,19,68
A03931,2024-03-13,29,28,17,74
A03932,2024-08-16,34,16,28,78
A03933,2024-07-19,26,12,28,66
A03934,2024-02-03,27,31,16,74
A03935,2024-05-19,19,37,36,92
A03936,2023-12-30,19,33,18,70
A03937,2024-08-16,35,36,10,81
A03938,2024-09-11,16,14,29,59
A03939,2024-06-25,26,12,40,78
A03940,2024-06-23,36,30,40,106
A03941,2024-02-09,16,40,30,86
A03942,2024-04-04,37,24,22,83
A03943,2024-05-09,12,38,23,73
A03944,2024-02-22,34,31,35,100
A03945,2024-10-16,20,17,37,74
A03946,2023-12-31,18,33,32,83
A03947,2024-08-04,13,19,38,70
A03948,2024-04-27,37,30,15,82
A03949,2024-04-06,32,17,25,74
A03950,2024-08-04,27,14,10,51
A03951,2024-10-29,36,29,27,92
A03952,2024-04-11,12,29,11,52
A03953,2024-05-15,26,40,18,84
A03954,2024-10-14,39,24,17,80
A03955,2024-10-25,20,35,17,72
A03956,2024-10-13,10,39,17,66
A03957,2023-12-17,36,15,14,65
A03958,2024-05-11,14,30,12,56
A03959,2024-06-03,27,36,23,86
A03960,2024-12-04,18,18,19,55
A03961,2024-05-13,32,28,19,79
A03962,2024-09-01,39,26,36,101
A03963,2024-07-18,38,10,12,60
A03964,2024-02-10,20,17,26,63
A03965,2024-07-11,23,37,19,79
A03966,2024-08-09,35,33,12,80
A03967,2023-12-29,30,18,27,75
A03968,2024-08-05,27,11,39,77
A03969,2024-11-08,14,28,33,75
A03970,2024-03-21,34,16,17,67
A03971,2024-06-14,32,12,16,60
A03972,2024-08-26,10,16,12,38
A03973,2024-08-05,15,35,30,80
A03974,2024-10-29,18,29,17,64
A03975,2024-05-20,29,21,20,70
A03976,2024-12-09,17,39,31,87
A03977,2023-12-18,35,19,15,69
A03978,2024-05-15,23,34,26,83
A03979,2024-05-19,15,10,10,35
A03980,2024-06-04,33,39,26,98
A03981,2024-07-01,23,31,16,70
A03982,2024-04-04,10,35,10,55
A03983,2024-05-02,21,20,14,55
A03984,2024-09-27,17,22,21,60
A03985,2024-05-22,31,13,36,80
A03986,2024-05-13,12,13,33,58
A03987,2024-05-14,28,14,12,54
A03988,2024-12-03,11,10,37,58
A03989,2024-02-10,39,28,23,90
A03990,2024-02-25,34,15,24,73
A03991,2024-02-28,15,18,28,61
A03992,2024-11-29,15,26,28,69
A03993,2024-04-18,34,31,23,88
A03994,2024-08-31,38,38,26,102
A03995,2024-10-31,40,36,24,100
A03996,2024-05-20,32,39,34,105
A03997,2024-04-01,20,19,17,56
A03998,2024-10-20,30,14,14,58
A03999,2024-06-10,40,39,14,93
A04000,2024-08-06,30,18,31,79
A04001,2024-08-31,28,26,19,73
A04002,2024-05-27,15,25,10,50
A04003,2024-07-30,16,38,16,70
A04004,2024-04-14,32,32,30,94
A04005,2024-06-19,35,34,39,108
A04006,2024-02-01,40,39,16,95
A04007,2024-01-23,12,33,27,72
A04008,2023-12-10,26,23,14,63
A04009,2024-08-08,32,13,23,68
A04010,2024-10-12,24,18,22,64
A04011,2024-10-14,16,22,32,70
A04012,2024-07-20,40,18,36,94
A04013,2024-03-18,14,39,13,66
A04014,2024-11-04,39,28,22,89
A04015,2024-10-31,20,39,18,77
A04016,2024-04-03,23,16,10,49
A04017,2024-01-03,34,14,13,61
A04018,2024-03-13,17,20,11,48
A04019,2023-12-31,18,15,13,46
A04020,2023-12-16,34,10,14,58
A04021,2024-03-15,32,26,36,94
A04022,2024-11-01,36,21,39,96
A04023,2024-07-25,38,21,29,88
A04024,2024-10-13,19,23,25,67
A04025,2024-01-06,28,31,33,92
A04026,2024-12-04,31,38,34,103
A04027,2024-08-14,31,29,37,97
A04028,2024-02-14,16,24,25,65
A04029,2023-12-16,23,19,12,54
A04030,2024-06-12,15,23,20,58
A04031,2024-08-23,29,23,40,92
A04032,2024-03-25,11,27,24,62
A04033,2024-03-11,21,36,26,83
A04034,2024-11-19,37,11,16,64
A04035,2024-07-18,30,13,31,74
A04036,2024-01-20,32,10,10,52
A04037,2024-01-18,32,13,23,68
A04038,2024-10-05,16,12,15,43
A04039,2024-03-07,19,12,25,56
A04040,2024-03-04,33,40,33,106
A04041,2024-10-12,13,15,14,42
A04042,2024-08-08,12,20,11,43
A04043,2024-06-11,40,18,39,97
A04044,2024-12-08,37,38,24,99
A04045,2024-11-19,40,23,18,81
A04046,2024-06-18,31,11,22,64
A04047,2024-10-22,39,10,28,77
A04048,2024-06-16,16,38,11,65
A04049,2024-05-16,32,24,29,85
A04050,2024-05-27,33,25,13,71
A04051,2024-02-20,20,38,21,79
A04052,2024-08-11,30,29,38,97
A04053,2024-09-28,32,33,31,96
A04054,2024-01-06,15,16,28,59
A04055,2024-08-16,36,34,33,103
A04056,2024-09-11,21,34,22,77
A04057,2024-01-19,13,27,10,50
A04058,2024-05-29,12,25,32,69
A04059,2024-09-24,25,25,15,65
A04060,2024-11-08,22,37,10,69
A04061,2024-10-05,15,38,28,81
A04062,2024-06-19,27,19,34,80
A04063,2024-07-19,18,27,13,58
A04064,2024-07-04,12,13,36,61
A04065,2024-08-11,24,39,37,100
A04066,2023-12-24,31,16,16,63
A04067,2024-07-29,39,22,32,93
A04068,2024-06-06,16,28,12,56
A04069,2024-01-28,21,25,13,59
A04070,2024-07-24,10,34,21,65
A04071,2024-12-02,35,12,14,61
A04072,2024-09-29,14,18,30,62
A04073,2023-12-12,28,14,40,82
A04074,2024-09-19,21,39,23,83
A04075,2024-07-12,16,17,39,72
A04076,2024-07-10,21,19,16,56
A04077,2023-12-10,32,16,33,81
A04078,2024-07-19,15,37,20,72
A04079,2024-04-20,27,38,37,102
A04080,2024-05-11,12,35,10,57
A04081,2024-06-01,19,10,37,66
A04082,2024-08-06,31,39,13,83
A04083,2024-05-24,23,32,38,93
A04084,2024-04-27,15,23,18,56
A04085,2024-05-23,38,29,11,78
A04086,2024-05-22,37,15,40,92
A04087,2024-07-15,16,15,24,55
A04088,2024-10-26,12,16,40,68
A04089,2024-08-28,27,24,31,82
A04090,2024-11-04,32,18,34,84
A04091,2023-12-23,23,11,32,66
A04092,2024-06-16,25,27,13,65
A04093,2023-12-21,32,29,24,85
A04094,2024-01-14,22,20,37,79
A04095,2024-05-18,24,13,16,53
A04096,2024-01-15,26,35,23,84
A04097,2024-12-08,33,20,26,79
A04098,2024-05-28,14,37,21,72
A04099,2024-04-16,34,36,20,90
A04100,2024-05-17,16,25,38,79
A04101,2024-09-01,35,33,36,104
A04102,2024-07-17,36,31,20,87
A04103,2024-05-23,27,33,20,80
A04104,2024-11-26,30,31,28,89
A04105,2024-03-01,14,24,38,76
A04106,2024-05-09,30,38,34,102
A04107,2024-07-19,14,28,38,80
A04108,2024-05-11,35,19,24,78
A04109,2024-11-04,12,39,31,82
A04110,2024-03-08,21,16,30,67
A04111,2024-03-24,18,13,28,59
A04112,2024-03-22,34,39,13,86
A04113,2024-07-12,26,33,36,95
A04114,2024-01-07,39,34,37,110
A04115,2024-10-04,17,14,31,62
A04116,2024-11-11,17,22,33,72
A04117,2024-08-08,12,25,38,75
A04118,2024-08-22,24,11,13,48
A04119,2024-04-01,38,19,11,68
A04120,2023-12-20,23,12,28,63
A04121,2024-02-10,10,20,20,50
A04122,2024-08-18,24,34,31,89
A04123,2024-04-23,10,13,15,38
A04124,2023-12-31,36,34,36,106
A04125,2024-12-01,15,24,17,56
A04126,2024-11-11,27,31,38,96
A04127,2024-07-05,30,17,12,59
A04128,2024-07-24,40,19,34,93
A04129,2024-02-13,28,31,40,99
A04130,2024-05-29,30,39,14,83
A04131,2024-10-17,38,28,15,81
A04132,2024-02-28,27,14,32,73
A04133,2024-07-02,17,27,33,77
A04134,2024-09-19,13,28,17,58
A04135,2024-01-10,31,32,40,103
A04136,2024-02-20,20,22,38,80
A04137,2024-08-18,21,24,25,70
A04138,2024-12-05,25,26,19,70
A04139,2024-10-13,20,26,30,76
A04140,2024-10-08,16,27,18,61
A04141,2024-06-23,12,33,23,68
A04142,2024-10-05,16,27,36,79
A04143,2024-07-09,25,34,34,93
A04144,2024-11-13,37,16,37,90
A04145,2024-06-13,37,16,12,65
A04146,2024-05-03,32,12,40,84
A04147,2024-09-12,12,19,20,51
A04148,2023-12-19,18,38,18,74
A04149,2024-09-23,17,38,18,73
A04150,2024-04-25,38,34,13,85
A04151,2024-01-18,29,17,25,71
A04152,2024-09-03,29,11,37,77
A04153,2024-05-31,30,21,38,89
A04154,2024-10-17,30,38,25,93
A04155,2024-07-27,24,17,24,65
A04156,2024-05-13,37,22,39,98
A04157,2024-01-07,16,19,26,61
A04158,2024-09-06,27,35,12,74
A04159,2024-06-27,12,32,36,80
A04160,2024-10-08,31,10,36,77
A04161,2023-12-13,39,11,36,86
A04162,2024-05-24,35,28,27,90
A04163,2024-01-05,40,14,12,66
A04164,2024-09-17,28,25,13,66
A04165,2024-08-09,28,12,14,54
A04166,2024-07-12,11,13,39,63
A04167,2024-03-11,12,15,15,42
A04168,2024-10-01,10,17,13,40
A04169,2024-02-16,35,34,13,82
A04170,2024-01-30,11,31,35,77
A04171,2024-11-17,29,34,32,95
A04172,2024-05-28,23,35,17,75
A04173,2024-01-29,17,37,23,77
A04174,2024-10-28,25,29,33,87
A04175,2024-12-01,11,16,23,50
A04176,2024-07-27,18,40,28,86
A04177,2024-10-27,40,23,27,90
A04178,2024-03-28,26,40,40,106
A04179,2023-12-13,27,16,18,61
A04180,2024-05-30,40,32,26,98
A04181,2024-04-12,31,39,18,88
A04182,2024-09-20,23,11,39,73
A04183,2024-03-23,22,13,32,67
A04184,2024-11-24,26,24,35,85
A04185,2024-03-24,10,40,10,60
A04186,2024-05-20,12,39,13,64
A04187,2024-05-26,30,30,40,100
A04188,2024-02-14,10,37,40,87
A04189,2023-12-18,38,26,15,79
A04190,2024-06-22,25,23,27,75
A04191,2024-05-16,26,23,13,62
A04192,2024-10-17,19,19,27,65
A04193,2024-08-08,10,37,23,70
A04194,2024-06-23,24,10,21,55
A04195,2024-03-10,19,20,26,65
A04196,2024-06-10,19,24,12,55
A04197,2024-09-03,33,12,13,58
A04198,2024-01-27,35,31,26,92
A04199,2024-02-28,39,21,16,76
A04200,2024-04-06,40,39,19,98
A04201,2024-07-23,11,24,34,69
A04202,2024-11-28,29,38,38,105
A04203,2024-08-22,29,35,34,98
A04204,2024-06-01,36,23,30,89
A04205,2024-04-25,40,27,27,94
A04206,2024-02-21,19,29,25,73
A04207,2024-11-12,30,25,36,91
A04208,2024-10-11,34,26,37,97
A04209,2024-07-01,31,29,39,99
A04210,2024-04-23,21,32,20,73
A04211,2023-12-17,15,25,33,73
A04212,2024-02-12,27,15,30,72
A04213,2024-05-14,34,39,21,94
A04214,2024-02-26,23,29,24,76
A04215,2024-11-21,18,26,36,80
A04216,2024-07-13,37,25,13,75
A04217,2024-04-15,30,27,37,94
A04218,2024-01-18,22,13,30,65
A04219,2024-11-30,11,40,17,68
A04220,2024-01-20,39,33,36,108
A04221,2024-10-14,39,39,18,96
A04222,2024-01-06,37,24,16,77
A04223,2024-08-06,13,14,33,60
A04224,2024-01-30,27,27,34,88
A04225,2024-01-02,27,15,14,56
A04226,2024-03-23,33,18,19,70
A04227,2024-12-07,39,18,29,86
A04228,2024-05-20,38,29,26,93
A04229,2024-10-30,18,15,11,44
A04230,2024-01-19,19,35,37,91
A04231,2024-10-19,19,10,13,42
A04232,2024-05-06,39,24,15,78
A04233,2024-11-26,22,11,11,44
A04234,2024-08-16,20,40,11,71
A04235,2023-12-21,14,29,30,73
A04236,2024-07-03,31,14,31,76
A04237,2024-08-21,34,13,16,63
A04238,2023-12-15,25,32,39,96
A04239,2024-04-23,38,20,40,98
A04240,2024-06-11,13,28,39,80
A04241,2024-01-20,19,27,31,77
A04242,2024-10-21,20,37,28,85
A04243,2024-09-18,16,24,17,57
A04244,2024-04-13,11,23,13,47
A04245,2024-01-14,24,18,37,79
A04246,2023-12-11,15,11,34,60
A04247,2024-02-10,24,19,16,59
A04248,2024-07-14,14,14,18,46
A04249,2024-10-03,35,24,13,72
A04250,2024-11-18,19,31,35,85
A04251,2023-12-30,19,11,38,68
A04252,2024-05-15,39,38,40,117
A04253,2024-10-20,20,40,15,75
A04254,2024-03-09,20,27,10,57
A04255,2024-11-24,23,22,27,72
A04256,2024-05-30,14,28,14,56
A04257,2024-10-30,32,38,21,91
A04258,2024-03-10,11,23,15,49
A04259,2024-11-09,23,32,15,70
A04260,2023-12-28,14,30,25,69
A04261,2024-03-16,19,15,24,58
A04262,2024-04-10,23,28,33,84
A04263,2024-07-24,15,26,18,59
A04264,2023-12-31,28,24,40,92
A04265,2024-11-04,19,23,27,69
A04266,2024-04-22,11,12,22,45
A04267,2024-04-27,36,20,38,94
A04268,2024-09-20,30,19,33,82
A04269,2024-05-05,13,36,27,76
A04270,2024-09-23,19,19,37,75
A04271,2024-01-30,37,24,40,101
A04272,2024-06-17,17,17,37,71
A04273,2024-10-04,24,22,27,73
A04274,2024-06-10,25,31,25,81
A04275,2024-10-14,33,23,31,87
A04276,2024-07-18,29,28,34,91
A04277,2024-01-20,37,29,16,82
A04278,2024-04-16,22,28,16,66
A04279,2024-04-05,35,13,10,58
A04280,2024-12-08,39,24,29,92
A04281,2024-10-19,26,19,21,66
A04282,2024-05-07,35,11,10,56
A04283,2024-09-29,12,31,11,54
A04284,2024-09-01,19,30,17,66
A04285,2024-06-30,10,39,11,60
A04286,2024-10-27,27,33,34,94
A04287,2024-08-26,22,26,14,62
A04288,2024-02-07,12,13,37,62
A04289,2024-09-19,31,11,35,77
A04290,2024-05-13,14,12,25,51
A04291,2024-11-05,14,13,14,41
A04292,2024-01-23,35,38,20,93
A04293,2024-08-30,20,37,35,92
A04294,2024-04-19,16,37,10,63
A04295,2023-12-27,17,35,17,69
A04296,2024-06-20,34,32,24,90
A04297,2024-02-24,21,39,19,79
A04298,2023-12-11,28,40,34,102
A04299,2024-08-02,38,27,25,90
A04300,2024-09-08,20,24,38,82
A04301,2024-03-24,25,24,19,68
A04302,2024-10-11,28,36,24,88
A04303,2023-12-26,39,17,20,76
A04304,2024-04-18,12,12,14,38
A04305,2024-07-03,30,29,28,87
A04306,2024-07-26,29,30,26,85
A04307,2024-03-30,17,12,14,43
A04308,2024-04-07,29,23,23,75
A04309,2024-08-12,32,29,13,74
A04310,2024-08-21,29,21,22,72
A04311,2024-03-10,24,15,22,61
A04312,2024-03-03,24,25,10,59
A04313,2024-11-22,40,15,11,66
A04314,2024-06-30,32,33,28,93
A04315,2024-02-22,40,25,26,91
A04316,2024-08-15,26,27,13,66
A04317,2024-03-31,25,38,38,101
A04318,2024-02-25,18,38,19,75
A04319,2024-09-20,11,39,28,78
A04320,2024-05-07,13,17,30,60
A04321,2024-11-17,12,35,16,63
A04322,2024-08-06,11,18,37,66
A04323,2024-02-09,36,30,21,87
A04324,2024-09-28,26,14,20,60
A04325,2024-04-15,37,30,21,88
A04326,2024-11-02,10,26,36,72
A04327,2024-05-09,13,27,21,61
A04328,2024-06-29,23,28,39,90
A04329,2024-06-25,16,20,36,72
A04330,2024-09-12,39,38,31,108
A04331,2024-08-23,16,17,28,61
A04332,2024-06-05,14,36,18,68
A04333,2024-03-11,23,23,34,80
A04334,2024-01-01,32,28,16,76
A04335,2024-01-06,15,17,28,60
A04336,2024-05-02,13,20,39,72
A04337,2024-05-24,12,35,28,75
A04338,2024-09-10,38,30,29,97
A04339,2024-11-20,16,20,19,55
A04340,2024-10-09,16,32,36,84
A04341,2024-05-03,22,23,17,62
A04342,2024-05-12,12,33,24,69
A04343,2024-04-30,19,30,24,73
A04344,2024-11-16,26,20,18,64
A04345,2023-12-17,20,35,24,79
A04346,2023-12-27,32,21,38,91
A04347,2024-10-28,24,14,28,66
A04348,2024-07-02,20,14,13,47
A04349,2024-09-11,25,37,27,89
A04350,2024-05-26,14,19,26,59
A04351,2024-07-04,17,24,30,71
A04352,2024-06-14,29,37,15,81
A04353,2024-04-26,10,30,32,72
A04354,2024-06-14,36,28,24,88
A04355,2024-03-10,23,39,31,93
A04356,2024-10-23,19,34,22,75
A04357,2024-04-05,16,14,33,63
A04358,2024-01-25,36,16,15,67
A04359,2024-05-29,25,20,39,84
A04360,2024-06-22,18,21,11,50
A04361,2024-09-01,11,21,17,49
A04362,2024-03-03,36,14,33,83
A04363,2024-10-28,12,40,20,72
A04364,2024-06-21,19,32,29,80
A04365,2024-07-28,10,35,25,70
A04366,2024-01-04,37,39,28,104
A04367,2024-03-16,25,26,12,63
A04368,2024-11-02,21,35,30,86
A04369,2024-04-24,14,21,19,54
A04370,2024-05-22,22,38,36,96
A04371,2024-03-02,30,10,13,53
A04372,2024-05-17,25,35,31,91
A04373,2023-12-18,31,24,38,93
A04374,2024-01-22,25,32,34,91
A04375,2024-09-03,17,15,17,49
A04376,2024-04-05,13,28,19,60
A04377,2024-05-12,28,38,11,77
A04378,2024-05-17,22,25,18,65
A04379,2024-02-01,27,28,15,70
A04380,2024-05-13,29,26,38,93
A04381,2024-12-08,34,34,32,100
A04382,2024-06-07,38,29,27,94
A04383,2024-07-08,32,18,19,69
A04384,2024-05-19,29,22,33,84
A04385,2024-07-15,23,19,28,70
A04386,2024-01-06,36,28,16,80
A04387,2024-10-13,29,38,33,100
A04388,2024-07-27,40,31,23,94
A04389,2024-08-15,30,39,12,81
A04390,2024-03-19,36,13,39,88
A04391,2023-12-22,29,11,17,57
A04392,2024-08-02,31,21,20,72
A04393,2024-12-08,12,10,16,38
A04394,2023-12-25,17,27,32,76
A04395,2024-08-09,19,13,25,57
A04396,2024-07-06,19,29,39,87
A04397,2024-08-29,16,19,30,65
A04398,2024-10-28,13,24,35,72
A04399,2024-08-26,36,29,17,82
A04400,2024-01-07,21,32,19,72
A04401,2024-03-04,14,14,35,63
A04402,2024-01-02,20,36,21,77
A04403,2024-02-17,38,14,31,83
A04404,2024-11-14,20,30,22,72
A04405,2024-09-09,32,15,34,81
A04406,2024-02-14,22,12,23,57
A04407,2024-02-01,36,26,15,77
A04408,2024-08-19,36,29,38,103
A04409,2024-05-11,20,21,27,68
A04410,2024-05-12,36,19,21,76
A04411,2024-11-22,11,28,16,55
A04412,2024-07-26,18,21,20,59
A04413,2024-12-09,22,14,13,49
A04414,2024-02-03,29,27,23,79
A04415,2023-12-22,30,11,34,75
A04416,2024-02-07,30,30,26,86
A04417,2024-04-14,23,11,29,63
A04418,2023-12-24,24,23,13,60
A04419,2024-05-04,22,18,19,59
A04420,2024-04-27,11,24,40,75
A04421,2024-04-09,32,31,14,77
A04422,2024-12-08,12,21,10,43
A04423,2024-10-25,24,35,35,94
A04424,2024-02-05,26,33,38,97
A04425,2024-09-03,18,21,23,62
A04426,2024-09-29,10,18,32,60
A04427,2024-09-03,28,18,27,73
A04428,2024-11-20,26,36,22,84
A04429,2024-02-21,34,30,11,75
A04430,2024-11-09,18,27,26,71
A04431,2024-05-10,25,37,25,87
A04432,2023-12-16,27,35,20,82
A04433,2024-09-28,27,10,40,77
A04434,2024-11-09,15,24,11,50
A04435,2024-01-19,38,35,35,108
A04436,2024-10-25,17,19,36,72
A04437,2024-01-26,31,33,38,102
A04438,2024-10-15,17,26,39,82
A04439,2024-08-13,24,19,25,68
A04440,2024-04-09,27,36,20,83
A04441,2024-04-18,21,29,40,90
A04442,2024-09-03,38,29,26,93
A04443,2024-08-28,37,13,21,71
A04444,2024-11-25,37,19,32,88
A04445,2024-11-26,33,15,20,68
A04446,2023-12-12,33,40,18,91
A04447,2024-03-20,13,28,12,53
A04448,2024-07-13,12,14,30,56
A04449,2024-10-20,32,13,10,55
A04450,2024-01-06,26,38,18,82
A04451,2024-07-17,23,31,36,90
A04452,2024-06-06,38,23,37,98
A04453,2024-01-22,12,36,29,77
A04454,2024-01-30,20,13,29,62
A04455,2024-08-10,13,30,36,79
A04456,2024-06-05,32,20,10,62
A04457,2024-06-06,11,13,24,48
A04458,2024-09-28,11,20,16,47
A04459,2024-01-22,30,24,22,76
A04460,2023-12-12,17,39,11,67
A04461,2024-09-14,31,19,31,81
A04462,2024-05-28,30,39,12,81
A04463,2024-03-22,13,20,21,54
A04464,2024-09-11,23,31,40,94
A04465,2024-11-21,33,20,33,86
A04466,2024-01-17,37,36,12,85
A04467,2024-11-17,16,10,31,57
A04468,2024-03-16,22,39,13,74
A04469,2024-10-14,40,34,21,95
A04470,2024-01-12,19,37,36,92
A04471,2024-08-13,13,39,24,76
A04472,2023-12-19,38,23,13,74
A04473,2024-11-08,24,30,30,84
A04474,2024-06-02,30,22,20,72
A04475,2024-09-04,15,22,16,53
A04476,2024-05-17,19,39,26,84
A04477,2024-08-27,31,36,37,104
A04478,2024-07-20,18,33,36,87
A04479,2024-02-05,20,28,19,67
A04480,2024-05-27,14,16,10,40
A04481,2024-08-04,34,10,22,66
A04482,2024-01-27,33,14,26,73
A04483,2024-08-17,11,10,14,35
A04484,2024-08-19,19,32,26,77
A04485,2024-06-13,18,18,14,50
A04486,2024-06-01,12,12,10,34
A04487,2024-01-08,30,29,10,69
A04488,2024-06-30,15,27,38,80
A04489,2024-01-01,13,22,24,59
A04490,2024-11-02,21,36,23,80
A04491,2024-06-11,12,32,37,81
A04492,2024-12-03,11,10,12,33
A04493,2024-07-23,29,24,25,78
A04494,2024-11-24,28,30,26,84
A04495,2024-03-27,10,11,21,42
A04496,2024-04-09,17,28,14,59
A04497,2024-02-26,12,33,36,81
A04498,2024-04-12,16,18,36,70
A04499,2023-12-12,27,21,11,59
A04500,2024-04-16,27,30,40,97
A04501,2024-04-25,10,20,11,41
A04502,2024-04-20,35,40,23,98
A04503,2024-03-31,15,11,34,60
A04504,2024-06-25,32,35,12,79
A04505,2024-05-02,16,16,29,61
A04506,2024-02-26,14,26,28,68
A04507,2024-02-01,22,32,31,85
A04508,2024-10-25,11,35,30,76
A04509,2024-07-19,35,39,28,102
A04510,2024-11-27,19,31,15,65
A04511,2024-09-19,25,17,13,55
A04512,2023-12-18,22,19,15,56
A04513,2024-04-08,27,34,29,90
A04514,2024-06-30,13,21,30,64
A04515,2024-11-19,17,24,24,65
A04516,2024-07-07,18,20,18,56
A04517,2024-06-24,22,14,15,51
A04518,2024-03-22,23,11,27,61
A04519,2024-03-03,28,35,30,93
A04520,2024-08-15,12,23,34,69
A04521,2024-02-13,37,24,30,91
A04522,2024-02-13,38,23,35,96
A04523,2024-03-25,14,27,25,66
A04524,2024-05-17,13,33,23,69
A04525,2024-09-22,10,17,16,43
A04526,2024-10-08,30,40,34,104
A04527,2024-05-05,19,17,17,53
A04528,2024-11-26,26,26,34,86
A04529,2024-04-23,16,15,10,41
A04530,2024-01-30,29,40,11,80
A04531,2024-01-30,36,19,25,80
A04532,2024-10-02,12,35,10,57
A04533,2024-04-28,39,31,16,86
A04534,2024-05-13,16,17,35,68
A04535,2024-07-11,33,36,30,99
A04536,2024-07-29,28,26,20,74
A04537,2024-10-14,27,18,13,58
A04538,2024-01-31,12,34,11,57
A04539,2024-10-19,10,36,30,76
A04540,2024-10-05,21,26,24,71
A04541,2024-02-13,13,35,10,58
A04542,2024-01-12,23,19,38,80
A04543,2024-03-24,30,20,37,87
A04544,2024-10-21,14,25,35,74
A04545,2023-12-21,26,11,33,70
A04546,2024-06-08,13,19,17,49
A04547,2024-06-15,16,20,24,60
A04548,2024-09-19,12,16,34,62
A04549,2024-12-04,13,30,33,76
A04550,2024-01-13,23,29,31,83
A04551,2024-03-04,11,36,14,61
A04552,2024-03-13,27,21,24,72
A04553,2024-03-01,22,19,36,77
A04554,2024-02-13,18,39,40,97
A04555,2024-08-02,13,33,19,65
A04556,2024-02-05,26,10,25,61
A04557,2024-06-04,32,26,36,94
A04558,2023-12-26,25,37,23,85
A04559,2024-09-11,16,17,17,50
A04560,2023-12-16,22,29,25,76
A04561,2024-09-23,29,19,36,84
A04562,2024-10-01,26,18,14,58
A04563,2024-11-16,29,21,25,75
A04564,2024-02-05,40,24,37,101
A04565,2024-08-02,37,22,22,81
A04566,2024-10-03,18,13,18,49
A04567,2024-08-15,13,14,20,47
A04568,2024-01-02,40,30,36,106
A04569,2024-06-20,20,35,16,71
A04570,2024-07-03,40,31,28,99
A04571,2024-04-09,37,30,36,103
A04572,2024-05-23,19,25,35,79
A04573,2024-02-06,21,36,27,84
A04574,2024-08-17,40,37,40,117
A04575,2024-02-07,23,27,26,76
A04576,2024-06-09,12,10,39,61
A04577,2024-05-26,16,39,13,68
A04578,2024-06-18,23,11,36,70
A04579,2024-11-09,35,35,23,93
A04580,2024-10-28,35,38,16,89
A04581,2024-10-27,36,38,23,97
A04582,2024-07-12,24,13,26,63
A04583,2024-03-27,37,31,14,82
A04584,2024-01-07,40,19,38,97
A04585,2024-08-23,14,16,30,60
A04586,2024-01-22,16,26,35,77
A04587,2024-03-10,14,23,36,73
A04588,2024-01-08,36,13,11,60
A04589,2024-04-30,22,12,19,53
A04590,2024-10-20,17,14,16,47
A04591,2024-06-10,27,16,11,54
A04592,2024-05-20,36,38,19,93
A04593,2024-02-27,17,36,20,73
A04594,2024-01-18,30,36,29,95
A04595,2024-12-01,37,28,37,102
A04596,2024-03-24,24,20,25,69
A04597,2024-03-13,25,29,18,72
A04598,2024-05-05,20,16,16,52
A04599,2024-08-12,34,40,33,107
A04600,2024-11-05,25,33,18,76
A04601,2024-11-10,12,12,30,54
A04602,2024-05-08,30,15,10,55
A04603,2024-10-13,15,21,37,73
A04604,2024-11-02,40,36,20,96
A04605,2024-05-04,21,14,25,60
A04606,2024-07-01,14,36,32,82
A04607,2024-11-09,20,10,14,44
A04608,2024-05-07,17,23,12,52
A04609,2024-07-27,30,17,36,83
A04610,2024-05-22,25,16,11,52
A04611,2024-09-13,20,16,33,69
A04612,2024-02-16,20,33,38,91
A04613,2024-01-01,18,10,18,46
A04614,2024-05-17,30,27,27,84
A04615,2024-07-20,13,28,34,75
A04616,2024-01-11,26,30,19,75
A04617,2024-02-07,11,38,13,62
A04618,2024-08-02,10,33,23,66
A04619,2024-08-02,21,26,35,82
A04620,2024-07-26,11,18,12,41
A04621,2023-12-19,21,10,22,53
A04622,2024-12-02,28,18,10,56
A04623,2024-02-29,21,25,20,66
A04624,2024-02-13,30,33,29,92
A04625,2024-06-19,17,25,12,54
A04626,2024-07-14,29,17,30,76
A04627,2024-01-01,23,26,34,83
A04628,2024-04-29,15,12,23,50
A04629,2024-06-08,36,14,30,80
A04630,2024-09-03,18,31,32,81
A04631,2024-08-23,33,38,29,100
A04632,2024-04-06,35,20,11,66
A04633,2024-03-04,19,20,30,69
A04634,2024-04-05,11,34,32,77
A04635,2024-04-26,39,11,31,81
A04636,2024-04-19,30,29,29,88
A04637,2024-08-31,38,32,31,101
A04638,2024-01-28,35,38,16,89
A04639,2024-09-01,34,29,24,87
A04640,2023-12-19,25,38,21,84
A04641,2024-11-29,11,19,37,67
A04642,2024-10-24,14,22,40,76
A04643,2024-02-12,30,35,38,103
A04644,2024-01-06,16,33,28,77
A04645,2024-10-18,37,35,24,96
A04646,2024-07-28,30,36,15,81
A04647,2024-06-30,34,28,34,96
A04648,2024-09-17,24,31,29,84
A04649,2024-06-04,36,14,22,72
A04650,2024-05-04,28,36,25,89
A04651,2024-03-17,26,29,38,93
A04652,2024-05-01,15,21,22,58
A04653,2024-09-19,40,21,14,75
A04654,2024-06-12,24,17,17,58
A04655,2024-08-06,15,32,24,71
A04656,2024-09-05,24,21,12,57
A04657,2024-08-05,38,26,30,94
A04658,2024-03-17,13,17,24,54
A04659,2024-09-23,21,22,37,80
A04660,2024-09-13,24,25,29,78
A04661,2024-09-03,14,34,10,58
A04662,2024-03-26,16,19,26,61
A04663,2024-04-03,40,32,20,92
A04664,2024-07-27,37,40,15,92
A04665,2023-12-20,30,36,26,92
A04666,2024-07-13,36,14,26,76
A04667,2024-01-04,23,31,23,77
A04668,2024-05-23,40,39,18,97
A04669,2023-12-22,20,37,29,86
A04670,2024-01-23,31,39,28,98
A04671,2024-11-04,34,18,11,63
A04672,2023-12-24,21,34,19,74
A04673,2024-07-22,18,33,39,90
A04674,2024-11-27,11,11,36,58
A04675,2024-01-12,36,29,20,85
A04676,2024-11-29,29,25,19,73
A04677,2024-10-28,29,40,31,100
A04678,2023-12-20,28,10,31,69
A04679,2024-09-06,19,10,14,43
A04680,2024-02-04,13,16,32,61
A04681,2024-08-15,39,23,21,83
A04682,2024-01-16,37,31,17,85
A04683,2024-02-07,35,14,14,63
A04684,2024-10-30,25,30,14,69
A04685,2024-11-08,10,11,39,60
A04686,2024-10-16,28,14,13,55
A04687,2024-05-04,32,25,32,89
A04688,2024-08-15,24,14,24,62
A04689,2024-12-08,10,40,33,83
A04690,2023-12-16,39,40,22,101
A04691,2024-01-18,10,18,13,41
A04692,2024-06-29,30,27,40,97
A04693,2024-04-04,39,13,28,80
A04694,2024-09-26,11,14,30,55
A04695,2024-04-20,17,28,10,55
A04696,2024-05-03,26,21,33,80
A04697,2024-07-06,10,25,29,64
A04698,2024-10-26,16,34,27,77
A04699,2024-07-28,30,38,20,88
A04700,2024-08-24,39,33,14,86
A04701,2024-07-24,38,39,40,117
A04702,2023-12-19,24,15,24,63
A04703,2023-12-25,40,24,26,90
A04704,2024-08-20,31,37,18,86
A04705,2024-10-08,15,34,17,66
A04706,2024-02-17,40,13,28,81
A04707,2024-06-05,25,25,31,81
A04708,2024-09-07,11,18,24,53
A04709,2024-01-24,37,15,37,89
A04710,2024-07-29,26,14,39,79
A04711,2024-07-03,15,25,30,70
A04712,2024-01-02,13,38,40,91
A04713,2024-04-05,32,10,11,53
A04714,2023-12-23,19,20,40,79
A04715,2024-12-02,25,35,17,77
A04716,2024-11-15,25,34,38,97
A04717,2024-01-27,16,10,22,48
A04718,2024-04-29,34,39,18,91
A04719,2024-04-25,26,19,33,78
A04720,2024-10-02,36,14,14,64
A04721,2024-05-26,27,35,10,72
A04722,2024-10-05,19,34,39,92
A04723,2024-04-12,17,10,10,37
A04724,2024-06-14,24,10,15,49
A04725,2024-10-09,13,38,23,74
A04726,2024-08-24,30,10,36,76
A04727,2024-05-26,10,30,36,76
A04728,2024-07-28,26,29,12,67
A04729,2024-08-30,23,27,11,61
A04730,2024-02-22,34,37,19,90
A04731,2024-11-27,37,36,34,107
A04732,2024-02-12,19,14,13,46
A04733,2024-01-27,30,37,37,104
A04734,2024-10-17,33,37,16,86
A04735,2024-08-05,10,38,35,83
A04736,2024-03-09,29,21,13,63
A04737,2024-07-22,19,39,31,89
A04738,2024-02-09,27,34,19,80
A04739,2024-03-14,10,26,38,74
A04740,2024-10-10,22,23,26,71
A04741,2024-09-17,32,15,36,83
A04742,2024-08-26,25,32,23,80
A04743,2024-03-27,22,32,27,81
A04744,2024-06-11,16,40,38,94
A04745,2024-10-21,17,26,36,79
A04746,2024-03-16,12,33,10,55
A04747,2024-01-12,16,15,18,49
A04748,2024-05-03,38,22,18,78
A04749,2024-10-04,11,28,32,71
A04750,2024-09-11,19,34,23,76
A04751,2024-04-21,12,38,30,80
A04752,2024-08-22,38,37,36,111
A04753,2024-06-01,35,15,11,61
A04754,2024-03-14,30,31,28,89
A04755,2024-05-17,38,25,18,81
A04756,2024-10-30,35,14,31,80
A04757,2024-02-09,37,24,31,92
A04758,2024-04-12,14,37,24,75
A04759,2024-02-16,27,34,16,77
A04760,2024-03-15,16,17,36,69
A04761,2024-08-31,37,35,27,99
A04762,2024-06-21,34,30,38,102
A04763,2024-11-14,36,35,29,100
A04764,2024-04-06,23,37,35,95
A04765,2024-10-29,32,29,34,95
A04766,2023-12-12,13,20,36,69
A04767,2024-07-19,29,14,22,65
A04768,2024-04-25,26,35,13,74
A04769,2024-06-15,30,36,21,87
A04770,2024-04-04,36,24,11,71
A04771,2024-10-25,33,12,30,75
A04772,2024-02-08,39,28,29,96
A04773,2024-08-20,33,30,13,76
A04774,2024-05-28,36,20,29,85
A04775,2024-09-24,23,31,16,70
A04776,2024-04-25,27,25,34,86
A04777,2024-09-06,34,25,39,98
A04778,2024-11-01,28,16,24,68
A04779,2024-03-31,26,24,25,75
A04780,2023-12-11,34,32,37,103
A04781,2024-07-07,31,23,10,64
A04782,2024-03-23,34,11,16,61
A04783,2024-01-24,23,21,16,60
A04784,2024-03-26,15,30,33,78
A04785,2024-11-19,35,23,17,75
A04786,2024-07-22,26,35,34,95
A04787,2023-12-26,10,31,33,74
A04788,2024-02-18,14,36,11,61
A04789,2023-12-28,19,23,31,73
A04790,2024-07-06,23,33,11,67
A04791,2024-06-14,16,16,37,69
A04792,2024-01-24,34,19,14,67
A04793,2023-12-23,12,23,11,46
A04794,2023-12-23,17,14,39,70
A04795,2024-10-03,33,18,39,90
A04796,2024-12-09,29,24,22,75
A04797,2024-08-28,26,29,10,65
A04798,2024-01-04,36,31,12,79
A04799,2024-04-13,21,15,12,48
A04800,2024-02-21,39,24,15,78
A04801,2024-06-12,33,19,34,86
A04802,2024-11-13,37,15,31,83
A04803,2024-08-12,37,12,17,66
A04804,2024-10-23,12,32,18,62
A04805,2024-11-29,25,31,35,91
A04806,2024-09-23,19,39,37,95
A04807,2024-09-02,38,24,17,79
A04808,2024-04-09,32,39,32,103
A04809,2024-11-03,11,12,29,52
A04810,2024-03-29,23,19,16,58
A04811,2024-10-17,30,13,17,60
A04812,2024-03-05,15,23,12,50
A04813,2024-01-16,24,34,22,80
A04814,2023-12-23,37,37,38,112
A04815,2024-06-27,19,16,29,64
A04816,2024-07-04,36,16,30,82
A04817,2024-06-29,26,25,21,72
A04818,2024-01-24,13,30,13,56
A04819,2024-07-11,13,13,29,55
A04820,2024-07-17,29,35,25,89
A04821,2024-05-06,34,16,12,62
A04822,2024-06-15,21,40,22,83
A04823,2024-06-15,19,15,30,64
A04824,2024-11-20,24,13,13,50
A04825,2024-10-15,17,30,39,86
A04826,2024-07-18,32,20,14,66
A04827,2024-09-29,28,22,16,66
A04828,2023-12-31,12,33,33,78
A04829,2024-04-16,28,33,15,76
A04830,2024-01-29,22,35,11,68
A04831,2024-03-25,32,40,35,107
A04832,2024-08-14,33,26,36,95
A04833,2024-11-22,25,13,10,48
A04834,2024-06-02,21,13,18,52
A04835,2024-04-26,32,39,17,88
A04836,2024-04-03,32,23,24,79
A04837,2024-09-09,25,16,18,59
A04838,2024-09-23,23,36,24,83
A04839,2024-04-12,24,34,18,76
A04840,2024-09-09,22,26,31,79
A04841,2024-01-11,14,19,27,60
A04842,2024-09-05,30,22,17,69
A04843,2024-07-10,17,39,28,84
A04844,2024-09-24,22,19,24,65
A04845,2024-06-01,30,30,11,71
A04846,2024-02-02,25,19,20,64
A04847,2024-02-28,36,34,24,94
A04848,2024-04-21,25,28,10,63
A04849,2024-09-07,22,15,31,68
A04850,2024-06-22,25,32,10,67
A04851,2024-04-30,23,32,32,87
A04852,2024-11-07,19,26,30,75
A04853,2024-08-12,35,27,16,78
A04854,2024-11-07,19,28,27,74
A04855,2024-06-14,21,30,11,62
A04856,2024-07-10,29,35,15,79
A04857,2024-08-21,28,15,39,82
A04858,2023-12-10,32,12,27,71
A04859,2024-02-05,13,26,36,75
A04860,2024-08-01,14,32,38,84
A04861,2024-02-16,16,30,24,70
A04862,2024-03-07,37,15,20,72
A04863,2024-04-07,12,34,36,82
A04864,2024-11-24,36,33,37,106
A04865,2024-06-19,33,31,33,97
A04866,2024-04-07,15,30,28,73
A04867,2024-02-03,16,33,20,69
A04868,2024-03-29,16,29,17,62
A04869,2024-12-08,22,36,20,78
A04870,2024-07-23,20,32,30,82
A04871,2024-01-30,26,28,13,67
A04872,2024-06-07,36,39,17,92
A04873,2024-05-30,33,35,15,83
A04874,2024-05-05,22,31,31,84
A04875,2024-03-10,10,32,25,67
A04876,2024-10-04,16,22,12,50
A04877,2024-03-30,10,28,12,50
A04878,2024-11-19,12,34,10,56
A04879,2024-11-08,38,22,30,90
A04880,2024-07-22,28,29,26,83
A04881,2024-05-01,32,20,30,82
A04882,2024-03-03,33,37,38,108
A04883,2024-10-31,29,28,24,81
A04884,2024-01-30,22,27,24,73
A04885,2024-09-27,37,13,26,76
A04886,2024-04-26,36,32,29,97
A04887,2024-10-24,31,30,12,73
A04888,2024-02-10,20,37,18,75
A04889,2024-01-20,36,24,14,74
A04890,2024-01-14,17,35,21,73
A04891,2024-10-18,29,29,26,84
A04892,2024-07-31,13,30,29,72
A04893,2024-05-14,30,38,13,81
A04894,2024-02-14,39,40,17,96
A04895,2024-01-02,14,33,26,73
A04896,2024-10-05,13,32,12,57
A04897,2024-06-06,40,24,15,79
A04898,2024-01-13,16,29,23,68
A04899,2024-03-14,39,28,20,87
A04900,2024-07-06,15,10,25,50
A04901,2024-02-01,28,36,18,82
A04902,2024-12-03,29,28,13,70
A04903,2024-03-29,28,35,34,97
A04904,2024-01-21,30,15,23,68
A04905,2024-02-21,10,10,35,55
A04906,2024-06-29,25,36,36,97
A04907,2024-10-01,24,21,34,79
A04908,2024-05-16,38,22,26,86
A04909,2024-09-11,35,29,21,85
A04910,2024-05-04,23,30,20,73
A04911,2024-05-11,25,14,37,76
A04912,2024-09-27,26,26,38,90
A04913,2024-10-26,17,39,17,73
A04914,2023-12-11,32,31,21,84
A04915,2024-02-08,13,39,25,77
A04916,2024-06-15,38,19,33,90
A04917,2024-08-16,38,39,16,93
A04918,2024-04-11,18,20,17,55
A04919,2024-01-04,36,14,14,64
A04920,2024-04-04,39,24,31,94
A04921,2024-07-04,28,26,12,66
A04922,2024-08-25,13,36,38,87
A04923,2024-09-30,10,27,27,64
A04924,2024-05-03,15,32,32,79
A04925,2024-02-15,37,18,21,76
A04926,2024-01-03,35,32,10,77
A04927,2024-01-08,15,18,26,59
A04928,2023-12-27,17,23,26,66
A04929,2024-02-18,18,19,20,57
A04930,2024-03-08,25,16,16,57
A04931,2024-06-16,17,34,22,73
A04932,2024-05-22,33,35,19,87
A04933,2024-01-09,10,28,34,72
A04934,2024-11-12,29,27,31,87
A04935,2024-01-12,21,16,20,57
A04936,2023-12-20,27,13,40,80
A04937,2024-04-30,29,32,18,79
A04938,2024-03-24,35,29,15,79
A04939,2024-03-30,34,10,10,54
A04940,2024-09-06,21,16,12,49
A04941,2023-12-28,37,11,31,79
A04942,2024-06-16,36,20,32,88
A04943,2023-12-22,38,26,34,98
A04944,2024-12-07,10,19,11,40
A04945,2024-02-19,15,31,20,66
A04946,2024-09-30,24,25,31,80
A04947,2024-02-08,26,40,27,93
A04948,2024-10-02,12,21,27,60
A04949,2024-11-06,13,22,12,47
A04950,2024-10-06,38,29,40,107
A04951,2024-06-03,20,20,32,72
A04952,2024-01-02,31,17,20,68
A04953,2024-10-09,39,26,15,80
A04954,2024-04-15,10,17,18,45
A04955,2024-01-04,32,33,34,99
A04956,2024-08-18,16,23,35,74
A04957,2024-02-12,40,23,30,93
A04958,2024-01-30,37,17,33,87
A04959,2024-11-12,19,32,23,74
A04960,2024-07-31,27,32,19,78
A04961,2024-08-19,37,40,40,117
A04962,2023-12-11,27,16,40,83
A04963,2024-11-23,21,33,36,90
A04964,2024-10-27,23,18,22,63
A04965,2024-05-27,16,36,21,73
A04966,2024-08-11,34,19,40,93
A04967,2024-09-25,40,37,36,113
A04968,2023-12-22,37,38,13,88
A04969,2024-08-17,16,38,33,87
A04970,2024-08-05,12,29,22,63
A04971,2023-12-22,25,18,38,81
A04972,2024-05-16,15,20,14,49
A04973,2024-08-03,35,37,34,106
A04974,2024-06-15,35,38,19,92
A04975,2023-12-10,32,32,32,96
A04976,2024-09-13,13,15,26,54
A04977,2024-05-28,37,17,16,70
A04978,2024-07-25,10,30,24,64
A04979,2023-12-15,28,38,19,85
A04980,2024-01-22,36,38,12,86
A04981,2024-03-03,28,10,27,65
A04982,2024-07-17,38,20,25,83
A04983,2023-12-24,32,36,38,106
A04984,2024-11-04,34,32,23,89
A04985,2024-11-21,25,18,39,82
A04986,2024-10-17,40,12,12,64
A04987,2024-10-21,17,13,27,57
A04988,2024-07-30,31,17,26,74
A04989,2024-12-03,21,33,18,72
A04990,2024-01-23,34,38,31,103
A04991,2024-02-23,13,21,24,58
A04992,2024-06-19,26,30,20,76
A04993,2024-04-03,38,19,40,97
A04994,2024-04-18,40,32,37,109
A04995,2024-05-20,28,39,25,92
A04996,2024-01-02,18,37,20,75
A04997,2024-07-26,34,29,39,102
A04998,2024-12-08,21,18,24,63
A04999,2024-03-23,23,36,22,81
A05000,2024-12-09,35,27,32,94